S.N.,Candidate,Party,EVM Votes,Postal Votes,Total Votes,% of Votes,Constituency ID
1,DR JITENDRA SINGH,Bharatiya Janata Party,566833,4243,571076,51.28,U084
2,CH LAL SINGH,Indian National Congress,444151,2552,446703,40.11,U084
3,GHULAM MOHD SAROORI,Independent,39519,80,39599,3.56,U084
4,MEHRAJ DIN,Independent,9055,27,9082,0.82,U084
5,AMIT KUMAR,Bahujan Samaj Party,8559,83,8642,0.78,U084
6,MOHD ALI GUJJAR,Independent,7139,19,7158,0.64,U084
7,MANOJ KUMAR,Ekam Sanatan Bharat Dal,6778,56,6834,0.61,U084
8,BALWAN SINGH,Jammu & Kashmir National Panthers Party (Bhim),3243,49,3292,0.3,U084
9,SWARN VEER SINGH JARAL,Independent,3071,17,3088,0.28,U084
10,DR PANKAJ SHARMA,Independent,2201,46,2247,0.2,U084
11,RAJESH MANCHANDA,Independent,1575,30,1605,0.14,U084
12,SACHIN GUPTA,Independent,1457,6,1463,0.13,U084
13,NOTA,None of the Above,12891,47,12938,1.16,U084
1,CHAMALA KIRAN KUMAR REDDY,Indian National Congress,623762,5381,629143,44.89,S2914
2,DR. BOORA NARSAIAH GOUD,Bharatiya Janata Party,401513,5460,406973,29.04,S2914
3,KYAMA MALLESH,Bharat Rashtra Samithi,254838,1349,256187,18.28,S2914
4,MAHAMD JAHANGIR,Communist Party of India  (Marxist),28412,318,28730,2.05,S2914
5,RAMESH GOUD THALLAPELLY,Alliance of Democratic Reforms Party,8130,16,8146,0.58,S2914
6,AITARAJU ABENDER,Bahujan Samaj Party,7703,66,7769,0.55,S2914
7,ASURA BALU,Independent,5747,3,5750,0.41,S2914
8,PULIGILLA BIXAPATHI YADAV,National Nava Kranthi Party,4718,0,4718,0.34,S2914
9,BUSHIPAKA VENKATAIAH,Independent,4674,1,4675,0.33,S2914
10,POOSA SRINIVAS,Telangana Rashtra Punahnirmana Samithi,4431,2,4433,0.32,S2914
11,NARENDRAA VEMULA,Jai Swaraj Party,4303,1,4304,0.31,S2914
12,KONGARI LINGA SWAMY,Dharma Samaj Party,4029,64,4093,0.29,S2914
13,TARIGOPPULA MAHENDER,Social Justice Party of India,3088,1,3089,0.22,S2914
14,KARINGULA YADAGIRI,Independent,2607,5,2612,0.19,S2914
15,BETHI NARENDER,Independent,2168,0,2168,0.15,S2914
16,M. GANESH,Pyramid Party of India,1996,14,2010,0.14,S2914
17,MALLEBOINA PARAMESH YADAV,Independent,1895,2,1897,0.14,S2914
18,LINGIDI. VENKATESWARLU,Prajavani  Party,1792,0,1792,0.13,S2914
19,V. SADANANDA REDDY,People Protection Party,1734,3,1737,0.12,S2914
20,DHERAVATH GOPI NAIK,Jai Maha Bharath Party,1678,4,1682,0.12,S2914
21,PENTA RAMESH,Independent,1646,1,1647,0.12,S2914
22,RACHA SUBHADRA REDDY,Socialist Party (India),1444,21,1465,0.1,S2914
23,VARIKUPPALA. KRISHNA VADDERA,Independent,1361,5,1366,0.1,S2914
24,BASHABOINA LAKSHMAIAH,Independent,1319,1,1320,0.09,S2914
25,NUNE VENKAT SWAMY,Independent,919,4,923,0.07,S2914
26,NARRI. SWAMY KURUMA,Independent,897,1,898,0.06,S2914
27,JANGA. SUJATHANAVEEN REDDY,Independent,847,0,847,0.06,S2914
28,ERRA SURYAM,Viduthalai Chiruthaigal Katchi,777,1,778,0.06,S2914
29,"KONGARI, MALLAIAH",Independent,631,2,633,0.05,S2914
30,DR : MORIGADI KRISHNA,Independent,616,1,617,0.04,S2914
31,KANDE. RAMARAJU,Independent,577,2,579,0.04,S2914
32,KOTHOJU SRINIVASU,National Maha Sabha Party,567,2,569,0.04,S2914
33,AMIREDDY KIRAN REDDY,Independent,540,1,541,0.04,S2914
34,CHANDU NAYAK MEGAVATH,Independent,501,1,502,0.04,S2914
35,KADIRE KIRAN KUMAR,Bahujan Republican  Socialist Party,476,2,478,0.03,S2914
36,KARUNAKAR REDDY NALLA,Jai Bharat National Party,446,1,447,0.03,S2914
37,KANDADI. MANIPAL REDDY,Telangana Republican Party,432,1,433,0.03,S2914
38,UDARI MALLESH,Independent,404,2,406,0.03,S2914
39,ANIL KUMAR GADEPAKA,Independent,390,3,393,0.03,S2914
40,NOTA,None of the Above,4571,75,4646,0.33,S2914
1,AMBICA G LAKSHMINARAYANA VALMIKI,Telugu Desam,755862,12383,768245,53.33,S0119
2,MALAGUNDLA SANKAR NARAYANA,Yuvajana Sramika Rythu Congress Party,573769,5921,579690,40.24,S0119
3,MALLIKARJUNA VAJJALA,Indian National Congress,41954,1263,43217,3,S0119
4,G.V.RAMANA REDDY,Independent,6436,3,6439,0.45,S0119
5,BANASI NARAYANAPPA,Bahujan Samaj Party,6280,116,6396,0.44,S0119
6,V.MURALI PRASAD REDDY,Independent,5775,3,5778,0.4,S0119
7,DR.NALLANI RAMESH NAIDU,Andhra Rastra Praja Samithi,4862,127,4989,0.35,S0119
8,M.SURENDRA,Pyramid Party of India,2927,8,2935,0.2,S0119
9,U.C.VENKATASUBBAIAH,Jaathia Chethi Vruthula Ikya Vedika Party,2533,7,2540,0.18,S0119
10,P.CHOWDESWARI,Independent,1514,4,1518,0.11,S0119
11,VADLA KESAVAIAH,Independent,1488,6,1494,0.1,S0119
12,B.RAGHAVENDRA PRASAD,Independent,1317,1,1318,0.09,S0119
13,KETHIREDDY RAGHUNATHAREDDY,Independent,1086,5,1091,0.08,S0119
14,LOKANATH GOWD SURAGOWINI,Independent,1085,6,1091,0.08,S0119
15,SREERANGARAJULA GOPINATH ROYAL,Independent,903,1,904,0.06,S0119
16,SHAIK.NIZAM,Samajwadi Party,749,4,753,0.05,S0119
17,RAMAVTH CHINNA RAMAPPA NAIK,Jaibhim Rao Bharat Party,735,10,745,0.05,S0119
18,KURUBA MALLIKARJUNA.S.,All India Kisan Janatha party,574,4,578,0.04,S0119
19,B.NAGAMUTHYALU,Socialist Unity Centre Of India (COMMUNIST),566,4,570,0.04,S0119
20,SRINIVASA RAJU.O,Bhartiya Panchyat Party,489,5,494,0.03,S0119
21,DURGA PRASAD D BYATARAYANAJI,Challengers Party,439,5,444,0.03,S0119
22,NOTA,None of the Above,9014,185,9199,0.64,S0119
1,SANJAY SETH,Bharatiya Janata Party,658975,5757,664732,45.91,S278
2,YASHASWINI SAHAY,Indian National Congress,537646,6574,544220,37.59,S278
3,DEVENDRA NATH MAHTO,Independent,130526,2121,132647,9.16,S278
4,SOMA SINGH,Jai Maha Bharath Party,10340,1,10341,0.71,S278
5,NIPU SINGH,Rashtriya Jansangharsh Swaraj Party,7793,10,7803,0.54,S278
6,DHANANJAY BHAGAT “GANDHI“,Mera Adhikaar Rashtriya Dal,6784,15,6799,0.47,S278
7,SHYAM  BIHARI PRAJAPATI,Bhagidari Party(P),6524,6,6530,0.45,S278
8,MANOJ KUMAR,Bahujan Samaj Party,6383,44,6427,0.44,S278
9,RAMHARI GOPE,Ambedkarite Party of India,6304,5,6309,0.44,S278
10,ANJANI PANDEY,Independent,5386,11,5397,0.37,S278
11,SARWESHWARI SAHU,Ekam Sanatan Bharat Dal,4794,8,4802,0.33,S278
12,HARINATH SAHU,Lokhit Adhikar Party,4120,16,4136,0.29,S278
13,HEMNTI DEVI,Samata Party,4069,11,4080,0.28,S278
14,RANJANA GIRI,Republican Party of India (A),3206,2,3208,0.22,S278
15,BIRENDRA NATH MANJHI,Abua Jharkhand Party,3130,25,3155,0.22,S278
16,DHARMENDRA TIWARY,Bhartiya Jantantra Morcha,3072,22,3094,0.21,S278
17,PRAWEEN KACHHAP,Sampoorna Bharat Kranti Party,2870,74,2944,0.2,S278
18,PRABEEN CHANDRA MAHATO,Independent,2852,7,2859,0.2,S278
19,SANTOSH KUMAR JAISWAL,Independent,2782,5,2787,0.19,S278
20,PANKAJ KUMAR RAVI,Peoples Party of India (Democratic),2756,7,2763,0.19,S278
21,MANORANJAN BHATTACHARYA,Independent,2537,2,2539,0.18,S278
22,AINUL ANSARI,Independent,2533,4,2537,0.18,S278
23,BINOD ORAON,Bahujan Mukti Party,2523,66,2589,0.18,S278
24,MINTU PASWAN,Socialist Unity Centre Of India (COMMUNIST),2151,13,2164,0.15,S278
25,KOLESHWAR MAHTO,Independent,1702,6,1708,0.12,S278
26,KAMESHWAR PRASAD SAW,Independent,1644,2,1646,0.11,S278
27,ARSHAD AYUB,Independent,1411,1,1412,0.1,S278
28,NOTA,None of the Above,8046,107,8153,0.56,S278
1,KANWAR SINGH TANWAR,Bharatiya Janata Party,475210,1296,476506,42.9,S249
2,KUNWAR DANISH ALI,Indian National Congress,447343,493,447836,40.32,S249
3,MUJAHID HUSAIN,Bahujan Samaj Party,163885,214,164099,14.77,S249
4,DHANISH,Independent,3615,2,3617,0.33,S249
5,SURESH,Independent,2716,1,2717,0.24,S249
6,JEETPAL RANA,Independent,2550,6,2556,0.23,S249
7,SUHEL HAIDER,Akhil Bhartiya Parivar Party,2492,12,2504,0.23,S249
8,NARENDRA SINGH,Independent,1776,3,1779,0.16,S249
9,NAEEMUDDIN,Independent,1002,2,1004,0.09,S249
10,KUSHAGRA,Independent,856,2,858,0.08,S249
11,KASHIF HUSAIN,Independent,677,2,679,0.06,S249
12,KUMDESH KUMAR,Independent,627,8,635,0.06,S249
13,NOTA,None of the Above,5886,14,5900,0.53,S249
1,RADHESHYAM RATHIYA,Bharatiya Janata Party,806667,1608,808275,55.63,S262
2,DR. MENKA DEVI SINGH,Indian National Congress,566487,1397,567884,39.08,S262
3,INNOCENT KUJUR - BIDANA ORAON,Bahujan Samaj Party,15493,107,15600,1.07,S262
4,ALBERT MING,Hamar Raj Party,10915,44,10959,0.75,S262
5,PRAKASH KUMAR URANW,Independent,7719,3,7722,0.53,S262
6,RUPNARAYAN EKKA,Independent,7410,10,7420,0.51,S262
7,GOWARDHAN RATHIA,Independent,4591,2,4593,0.32,S262
8,POOJA SIDAR,Independent,4159,8,4167,0.29,S262
9,MADAN PRASAD GOND,Gondvana Gantantra Party,3007,8,3015,0.21,S262
10,GULESHWAR PAINKRA,Bhartiya Shakti Chetna Party,2618,8,2626,0.18,S262
11,UDAY KUMAR RATHIA,Independent,2127,2,2129,0.15,S262
12,ABHAY KUMAR EKKA,Independent,1808,17,1825,0.13,S262
13,BADAL EKKA,Sarv Adi Dal,1714,14,1728,0.12,S262
14,NOTA,None of the Above,14993,29,15022,1.03,S262
1,KHALILUR RAHAMAN,All India Trinamool Congress,543449,978,544427,39.75,S259
2,MURTOJA HOSSAIN BOKUL,Indian National Congress,427105,685,427790,31.23,S259
3,DHANANJAY GHOSH,Bharatiya Janata Party,339868,946,340814,24.88,S259
4,REJAUL MONDAL,Independent,7500,0,7500,0.55,S259
5,SAJAHAN BISWAS,All India Secular Front,6847,11,6858,0.5,S259
6,MUKTIPADA KONAI,Independent,5670,1,5671,0.41,S259
7,ASHISH BHUIMALI,Independent,3949,2,3951,0.29,S259
8,MD SARWARUL ISLAM SARKAR,Bahujan Samaj Party,3511,4,3515,0.26,S259
9,MD SAHABUDDIN,Social Democratic Party Of India,3489,7,3496,0.26,S259
10,SAMIRUDDIN,Socialist Unity Centre Of India (COMMUNIST),1946,4,1950,0.14,S259
11,PARIMAL GHOSH,Independent,1928,3,1931,0.14,S259
12,SANUAR ALI,Bharatheeya Jawan Kisan Party,1698,2,1700,0.12,S259
13,RAJIB CHATTERJEE,Bhartiya Lokmat Rashtrwadi Party,1527,5,1532,0.11,S259
14,MD ASADUL BISWAS,Independent,1340,0,1340,0.1,S259
15,NOTA,None of the Above,17135,23,17158,1.25,S259
1,SHOBHA KARANDLAJE,Bharatiya Janata Party,982805,3244,986049,56.27,S1024
2,PROFESSOR M.V RAJEEV GOWDA,Indian National Congress,725190,1383,726573,41.46,S1024
3,GOVINDAIAH,Bahujan Samaj Party,4614,17,4631,0.26,S1024
4,SANTHOSH M,Uttama Prajaakeeya Party,3450,11,3461,0.2,S1024
5,UDAYA SHANKAR.G,Prahar Janshakti Party,2676,2,2678,0.15,S1024
6,LAKSHMI SRIHARI.J.N.,Independent,2091,3,2094,0.12,S1024
7,DILIP KUMAR I.S.,Independent,1896,7,1903,0.11,S1024
8,K.M.MAHADEVA,Independent,1716,4,1720,0.1,S1024
9,K.V.NANJUNDASWAMY,Independent,1363,2,1365,0.08,S1024
10,SHOBHA,Independent,1272,8,1280,0.07,S1024
11,Y.R.KALLESHWARI,Samajwadi Janata Party(Karnataka),1072,5,1077,0.06,S1024
12,NIRMALA H.L,Socialist Unity Centre Of India (COMMUNIST),972,5,977,0.06,S1024
13,H.R.NATARAJ,Independent,857,4,861,0.05,S1024
14,BHASKAR ANKALAMADUGU SHIVAREDDY,Independent,831,0,831,0.05,S1024
15,SHIVAKUMAR. B,Karnataka Rashtra Samithi,813,4,817,0.05,S1024
16,SUDHA.  V,Independent,650,7,657,0.04,S1024
17,KRISHNAIAH,Rashtriya Samaj Dal (R),556,3,559,0.03,S1024
18,HEBBAL VENKATESH.J,Republican Party of India (A),422,3,425,0.02,S1024
19,"GLOBE STAR J. JAI SIMHA VARMA, B E.",Gareeb Aadmi Party,356,3,359,0.02,S1024
20,SHOBAN BABU  V,Indian Labour Party (Ambedkar Phule),315,5,320,0.02,S1024
21,PARASAPPA BHEEMAPPA GAJJERI,Rani Chennamma Party,313,0,313,0.02,S1024
22,NOTA,None of the Above,13499,55,13554,0.77,S1024
1,SALENG A SANGMA,Indian National Congress,382058,1861,383919,56.96,S152
2,AGATHA K SANGMA,National People's Party,227210,1468,228678,33.93,S152
3,ZENITH M SANGMA,All India Trinamool Congress,48518,191,48709,7.23,S152
4,LABENN CH MARAK,Independent,6846,64,6910,1.03,S152
5,NOTA,None of the Above,5809,31,5840,0.87,S152
1,SAJDA AHMED,All India Trinamool Congress,722586,2036,724622,52.1,S2526
2,ARUNUDAY PAULCHOWDHURY,Bharatiya Janata Party,504611,1338,505949,36.38,S2526
3,AZAHAR MOLLICK,Indian National Congress,78304,285,78589,5.65,S2526
4,MOFIKUL ISLAM,All India Secular Front,38971,20,38991,2.8,S2526
5,ARIT KARAK,Independent,7287,5,7292,0.52,S2526
6,AMAL KUMAR DEYATI,Bharatiya Nyay-Adhikar Raksha Party,5445,6,5451,0.39,S2526
7,RAMESH KHANRA,Independent,5094,10,5104,0.37,S2526
8,BIMALESH KUMAR HELA,Bahujan Samaj Party,4867,8,4875,0.35,S2526
9,SK. SAPIYAR ALI,Independent,2924,0,2924,0.21,S2526
10,NIKHIL BERA,Socialist Unity Centre Of India (COMMUNIST),2095,12,2107,0.15,S2526
11,AMAL KUMAR BARMAN,Independent,1997,3,2000,0.14,S2526
12,RAMPRASAD GHORAI,Indian Unity Centre,1568,4,1572,0.11,S2526
13,NOTA,None of the Above,11263,55,11318,0.81,S2526
1,ANITA NAGARSINGH CHOUHAN,Bharatiya Janata Party,793432,2431,795863,51.93,S1224
2,KANTILAL BHURIA,Indian National Congress,586904,1727,588631,38.41,S1224
3,ENGINEER BALUSINGH GAMAD,Bharat Adivasi Party,52525,234,52759,3.44,S1224
4,RAMCHANDRA SOLANKI,Bahujan Samaj Party,15159,13,15172,0.99,S1224
5,SURAJ BHABHAR,Independent,10060,2,10062,0.66,S1224
6,RANGLA KALESH,Independent,7331,4,7335,0.48,S1224
7,KASNA RANA PARGI,Independent,7311,5,7316,0.48,S1224
8,SUMITRA MEDA,Independent,6927,3,6930,0.45,S1224
9,RAMESHWAR SINGAR,Independent,4603,4,4607,0.3,S1224
10,MOHANSINGH NINGWAL,Bhartiya Samajik Party,4503,4,4507,0.29,S1224
11,SHEETAL BARELA,Akhand Bharat Samrajya Party,3929,1,3930,0.26,S1224
12,UDESINGH MACHAR,Republican Party of India (A),3795,1,3796,0.25,S1224
13,NOTA,None of the Above,31697,38,31735,2.07,S1224
1,G. KISHAN REDDY,Bharatiya Janata Party,468311,4701,473012,45.15,S298
2,DANAM NAGENDER,Indian National Congress,420220,2848,423068,40.38,S298
3,PADMA RAO . T,Bharat Rashtra Samithi,128680,906,129586,12.37,S298
4,DR.  BASWANANDAM DANDEPU,Bahujan Samaj Party,2248,20,2268,0.22,S298
5,SARARAPU SRISAILAM,Telangana Rajya Samithi,1726,1,1727,0.16,S298
6,SAPAVAT SUMAN,Independent,996,0,996,0.1,S298
7,R.S.J. THOMAS,Jai Swaraj Party,971,3,974,0.09,S298
8,RAASALA VINOD KUMAR,Dharma Samaj Party,820,6,826,0.08,S298
9,KOLISETTY SHIVA KUMAR,Yuga Thulasi Party,678,1,679,0.06,S298
10,MACHCHERLA VENKATA REDDY,Independent,672,1,673,0.06,S298
11,MOHAMMED AKRAM ALI KHAN,Independent,596,1,597,0.06,S298
12,MOHAMMED RAFIUDDIN KALEEM,All India Majlis-E-Inquilab-E-Millat,478,6,484,0.05,S298
13,LUNAVATH HARI RAM,Independent,474,0,474,0.05,S298
14,BOGGULA SUNIITHHA,Independent,417,1,418,0.04,S298
15,MOHAMMED AYUB ALI,Anna YSR Congress Party,406,4,410,0.04,S298
16,MOHAMMED FASI UDDIN,Independent,341,1,342,0.03,S298
17,PULIMAMIDI VENKATESH GUPTA,Independent,340,0,340,0.03,S298
18,IBRAHIM KHAN,Independent,315,5,320,0.03,S298
19,ANDRAPU SUDARSHAN,Independent,312,3,315,0.03,S298
20,JUNAID ANAM SIDDIQUI,Independent,294,1,295,0.03,S298
21,KRANTHI KUMAR BANDELA,Indian National Yuva Jana Party,283,2,285,0.03,S298
22,DR. R. GANGADHAR,Socialist Unity Centre Of India (COMMUNIST),280,1,281,0.03,S298
23,UTTAM PRAVEEN KUMAR,Independent,273,1,274,0.03,S298
24,GOWLIKAR SONY,Social Justice Party of India,269,3,272,0.03,S298
25,BATHULA RAVI,Independent,252,0,252,0.02,S298
26,P C LINGANNA,Independent,243,0,243,0.02,S298
27,MOHAMMED IBRAHIM AHMED,Independent,240,2,242,0.02,S298
28,SANGALA FLORY,Independent,223,0,223,0.02,S298
29,MOHAMMED ABDUL AZEEM,Independent,220,1,221,0.02,S298
30,GANESH BHARGAVI GUNDE,Jai Bharat National Party,220,3,223,0.02,S298
31,V. K. VIJAYA LAKSHMI,Independent,213,3,216,0.02,S298
32,CHEEKATI BHUPAL GOUD,All India Backward People Sunami Party,209,1,210,0.02,S298
33,BOMMAKANTI SOWMYA,Pyramid Party of India,201,4,205,0.02,S298
34,KRUPAVARAM GANDU,Independent,159,2,161,0.02,S298
35,PAMPARI NARENDER,Independent,143,0,143,0.01,S298
36,SYED KHADER,Independent,132,1,133,0.01,S298
37,B . SUNITHA RANI,Socialist Party (India),130,3,133,0.01,S298
38,CHALIKA CHANDRA SEKHAR,Independent,129,0,129,0.01,S298
39,PAGIDIPALLI SHYAMSON,Viduthalai Chiruthaigal Katchi,126,4,130,0.01,S298
40,REDDYMALLA PARVATHI,Independent,126,1,127,0.01,S298
41,VELAMARTHI. RAVI KIRAN,Independent,123,1,124,0.01,S298
42,K. MURALI KRISHNA,Independent,120,0,120,0.01,S298
43,DEVENDAR KONNE,Independent,117,0,117,0.01,S298
44,KONDOJU MOHAN,Independent,113,1,114,0.01,S298
45,MD KHALEEL UZ ZAMA,Independent,110,1,111,0.01,S298
46,NOTA,None of the Above,5092,74,5166,0.49,S298
1,CHHATRAPATI SHAHU SHAHAJI,Indian National Congress,750323,4199,754522,54.15,S1347
2,SANJAY SADASHIVRAO MANDLIK,Shiv Sena,597014,2544,599558,43.03,S1347
3,SANJAY BHIKAJI MAGADE,Bahujan Samaj Party,3946,56,4002,0.29,S1347
4,MUSHTAK AJIJ MULLA,Independent,3822,2,3824,0.27,S1347
5,MADHURI RAJU JADHAV,Independent,3503,5,3508,0.25,S1347
6,KHADE BAJIRAO NANASO,Independent,3497,15,3512,0.25,S1347
7,KRUSHNABAI DIPAK CHOUGALE,Independent,3045,18,3063,0.22,S1347
8,KOGALE SANDEEP BHAIRAVNATH,Desh Janhit Party,2952,23,2975,0.21,S1347
9,ADV. YASH SUHAS HEGDEPATIL,Independent,2457,2,2459,0.18,S1347
10,NAGNATH PUNDALIK BENAKE,Independent,1215,12,1227,0.09,S1347
11,RAJANDARA BALASO KOLI,Independent,1029,15,1044,0.07,S1347
12,B. T. PATIL (EX SERVICEMAN),Bharatheeya Jawan Kisan Party,1011,96,1107,0.08,S1347
13,SUBHASH VAIJU DESAI,Independent,847,2,849,0.06,S1347
14,MANGESH JAYSINGH PATIL,Independent,647,6,653,0.05,S1347
15,SHASHIBHUSHAN JEEVANRAO DESAI,Akhil Bharat Hindu Mahasabha,636,15,651,0.05,S1347
16,SANTOSH GANPATI BISURE,Apni Prajahit Party,635,4,639,0.05,S1347
17,DR. SUNIL NAMDEV PATIL,National Black Panther Party,626,7,633,0.05,S1347
18,KRUSHNA HANMANT DESAI,Independent,602,2,604,0.04,S1347
19,IRFAN ABUTALIB CHAND,Independent,595,2,597,0.04,S1347
20,MANE ARVIND BHIVA,Bhartiya Rashtriya Dal,558,12,570,0.04,S1347
21,SANDEEP GUNDOPANT SANKPAL,Independent,541,3,544,0.04,S1347
22,KUDARTULLA ADAM LATIF,Independent,465,2,467,0.03,S1347
23,SALIM NURMUHAMAD BAGWAN,Independent,334,1,335,0.02,S1347
24,NOTA,None of the Above,5932,51,5983,0.43,S1347
1,RAMPRIT MANDAL,Janata Dal  (United),532138,894,533032,48.73,S047
2,SUMAN KUMAR MAHASETH,Vikassheel Insaan Party,347989,874,348863,31.9,S047
3,GULAB YADAV,Bahujan Samaj Party,73532,352,73884,6.76,S047
4,RAM PRASAD RAUT,Independent,25993,17,26010,2.38,S047
5,GANGA PRASAD YADAV,Independent,18064,10,18074,1.65,S047
6,GAURI SHANKAR SAHU,Independent,14307,18,14325,1.31,S047
7,RAJIV KUMAR JHA,Independent,12488,25,12513,1.14,S047
8,BABLU KUMAR,Aadarsh Mithila Party,11638,35,11673,1.07,S047
9,VIDYA NAND RAM,Wazib Adhikar Party,10843,19,10862,0.99,S047
10,VIJAY KUMAR MANDAL,Socialist Unity Centre Of India (COMMUNIST),8556,21,8577,0.78,S047
11,NOTA,None of the Above,35846,82,35928,3.28,S047
1,BAIJAYANT PANDA,Bharatiya Janata Party,612916,2789,615705,48.21,S1815
2,ANSHUMAN MOHANTY,Biju Janata Dal,547681,1488,549169,43,S1815
3,SIDHARTH SWARUP DASH,Indian National Congress,94595,237,94832,7.43,S1815
4,SOUBHAGYA KETAN SAMAL,Socialist Unity Centre Of India (COMMUNIST),3393,2,3395,0.27,S1815
5,SEKHA SADIKA HOSEN,Bahujan Samaj Party,1845,7,1852,0.15,S1815
6,SUPRAVA DAS,Akhil Bhartiya Parivar Party,1559,2,1561,0.12,S1815
7,SRIRAM PANDEY,Independent,1397,2,1399,0.11,S1815
8,SANTOSH KUMAR PATRA,Independent,1370,3,1373,0.11,S1815
9,PRATAP CHANDRA MOHANTY,Independent,1088,7,1095,0.09,S1815
10,PRANGYAN PRAKASH MOHAPATRA,Odisha Janata Party,910,2,912,0.07,S1815
11,NOTA,None of the Above,5807,8,5815,0.46,S1815
1,JAGADISH CHANDRA BARMA BASUNIA,All India Trinamool Congress,785747,2628,788375,48.57,S251
2,NISITH PRAMANIK,Bharatiya Janata Party,745144,3981,749125,46.16,S251
3,NITISH CHANDRA ROY,All India Forward Bloc,29992,275,30267,1.86,S251
4,PIYA ROY CHOWDHURY,Indian National Congress,10539,140,10679,0.66,S251
5,HAREKRISHNA SARKAR,Independent,9462,5,9467,0.58,S251
6,KAMALESH BARMAN,Independent,2972,21,2993,0.18,S251
7,NABI BARMAN,Independent,2710,14,2724,0.17,S251
8,SUBODH BARMAN,Independent,2594,5,2599,0.16,S251
9,DILIP CHANDRA BARMAN,Socialist Unity Centre Of India (COMMUNIST),2449,19,2468,0.15,S251
10,PURNA MOHAN ROY,Bahujan Samaj Party,2087,10,2097,0.13,S251
11,BIDHAN DAS,Independent,2067,5,2072,0.13,S251
12,KISHORE RAY,Independent,1588,18,1606,0.1,S251
13,PRADIP KUMAR ROY,Kamatapur People’s Party (United),1499,19,1518,0.09,S251
14,AMAL DAS,Independent,1488,7,1495,0.09,S251
15,NOTA,None of the Above,15510,53,15563,0.96,S251
1,KADIYAM KAVYA,Indian National Congress,575566,5728,581294,45.85,S2915
2,AROORI RAMESH,Bharatiya Janata Party,355875,5080,360955,28.47,S2915
3,Dr. MARAPALLY SUDHEER KUMAR,Bharat Rashtra Samithi,230820,1213,232033,18.3,S2915
4,AMBOJU BUDDAIAH,Alliance of Democratic Reforms Party,11103,12,11115,0.88,S2915
5,KALPANA PANJA,Bahujan Samaj Party,9230,97,9327,0.74,S2915
6,KONGARA ANIL KUMAR,Independent,6259,0,6259,0.49,S2915
7,ANIL KUMAR GADEPAKA,Independent,4482,4,4486,0.35,S2915
8,BUNGA JYOTHI RAMANA,Aihra National Party,4262,3,4265,0.34,S2915
9,MEKALA SUMAN,Dharma Samaj Party,3972,66,4038,0.32,S2915
10,AR NENA PREM READY RIPEEKA,Mana Telangana Rashtra Samaikya Party,3625,9,3634,0.29,S2915
11,KOYYADA NARESH,Independent,3283,3,3286,0.26,S2915
12,PRAMEELA JANNU,Independent,3022,0,3022,0.24,S2915
13,BARIGELA SHIVA,Independent,2947,2,2949,0.23,S2915
14,S P K  SAGAR,Jai Maha Bharath Party,2769,4,2773,0.22,S2915
15,PASULA RAVI,Republican Party of India (Athawale),2220,19,2239,0.18,S2915
16,DEVARAJU PENDELA,Rashtriya Praja Congress  (Secular),2072,11,2083,0.16,S2915
17,POTHARAJU NARASIMHARAJU,Independent,1955,0,1955,0.15,S2915
18,BOLLAM VIJAY KUMAR,Independent,1821,4,1825,0.14,S2915
19,MACHA DEVENDER,Viduthalai Chiruthaigal Katchi,1753,16,1769,0.14,S2915
20,ROOPA POLEPAKA,Independent,1657,2,1659,0.13,S2915
21,NARMADA PRAVEEN,Pyramid Party of India,1657,7,1664,0.13,S2915
22,DHAYAKAR GAJJI,Independent,1637,1,1638,0.13,S2915
23,POGULA ASHOK,Independent,1333,4,1337,0.11,S2915
24,THANDRA ESHWAR,Independent,1290,2,1292,0.1,S2915
25,MANDA NARESH,Independent,1044,7,1051,0.08,S2915
26,KOTHAPALLI SAVITHRI,Marxist Communist Party of India (United),1018,5,1023,0.08,S2915
27,PUTTA VINOD KUMAR,Independent,908,1,909,0.07,S2915
28,BOCHU RAJU,Independent,905,8,913,0.07,S2915
29,PAITHARA ACHYUTH,Independent,901,5,906,0.07,S2915
30,MANGALAPELLI ASHAIAH,Independent,847,0,847,0.07,S2915
31,GADDAM CHIRANJEEVI,Independent,825,1,826,0.07,S2915
32,MOTHKUPELLY PRABHAKAR,Independent,818,1,819,0.06,S2915
33,GANNARAPU RAVINDER,Independent,752,0,752,0.06,S2915
34,GANIPAKA PRADEEP,Independent,710,3,713,0.06,S2915
35,RAMESH BABU SHANIGARAPU,Independent,658,4,662,0.05,S2915
36,Dr GADAM MALLESH,Jai Bharat National Party,563,4,567,0.04,S2915
37,THALLAPALLY VENKATAIAH,Independent,538,0,538,0.04,S2915
38,BASHIPAKA SUDHAKAR,Independent,503,2,505,0.04,S2915
39,RK GANAPURAM,Independent,468,6,474,0.04,S2915
40,CHILUVERU PRATHAP,Independent,399,2,401,0.03,S2915
41,THATIKAYALA SATHISH BABU,Independent,382,2,384,0.03,S2915
42,CHILUMULLA SUJATHA,Independent,377,2,379,0.03,S2915
43,NOTA,None of the Above,8209,171,8380,0.66,S2915
1,KALI CHARAN SINGH,Bharatiya Janata Party,568912,5644,574556,52.89,S274
2,KRISHNA NAND TRIPATHI,Indian National Congress,348110,5487,353597,32.55,S274
3,AMIT KUMAR SINGH,Independent,31976,15,31991,2.94,S274
4,ARJUN KUMAR,Communist Party of India,14062,60,14122,1.3,S274
5,DR. ABHISHEK KUMAR SINGH,Independent,14038,68,14106,1.3,S274
6,ARJUN PRAJAPATI,Independent,13320,8,13328,1.23,S274
7,DEEPAK KUMAR GUPTA,Independent,12384,182,12566,1.16,S274
8,NAGMANI,Bahujan Samaj Party,11798,152,11950,1.1,S274
9,CHANDAN KUMAR,Independent,6569,13,6582,0.61,S274
10,MD ABUZAR KHAN,Independent,5820,3,5823,0.54,S274
11,YOGESH KUMAR SINGH,Independent,5110,2,5112,0.47,S274
12,BIMAL LAKRA,Ambedkarite Party of India,4983,31,5014,0.46,S274
13,KARMLAL ORAON,Peoples Party of India (Democratic),3968,42,4010,0.37,S274
14,SUMIT KUMAR YADAV,Samata Party,3499,17,3516,0.32,S274
15,SANJAY KUMAR SNEHI,Lokhit Adhikar Party,3202,14,3216,0.3,S274
16,MAHESH BANDO,Bahujan Mukti Party,3159,42,3201,0.29,S274
17,SRIRAM SINGH,Independent,2991,2,2993,0.28,S274
18,DARSHAN GANJHU,Jharkhand Party,2780,37,2817,0.26,S274
19,DULESHWAR SAW,Bharatheeya Jawan Kisan Party,2376,9,2385,0.22,S274
20,LAW KUMAR PANDIT,Bhagidari Party(P),2372,8,2380,0.22,S274
21,KAMDEO DIHO RANA,Rashtriya Jan Utkarsh Party,2297,12,2309,0.21,S274
22,VIKRANT KUMAR SINGH,Independent,2288,1,2289,0.21,S274
23,NOTA,None of the Above,8435,76,8511,0.78,S274
1,JAGANNATH SARKAR,Bharatiya Janata Party,778046,4350,782396,50.78,S2513
2,MUKUT MANI ADHIKARI,All India Trinamool Congress,592276,3221,595497,38.65,S2513
3,ALAKESH DAS,Communist Party of India  (Marxist),122970,840,123810,8.04,S2513
4,BIPLAB BISWAS,Bahujan Samaj Party,9319,73,9392,0.61,S2513
5,PARESH HALDAR,Socialist Unity Centre Of India (COMMUNIST),8223,16,8239,0.53,S2513
6,JAGANNATH SARKAR,Independent,5831,30,5861,0.38,S2513
7,SHYAMAL KUMAR MALLICK,Independent,5533,11,5544,0.36,S2513
8,NOTA,None of the Above,9798,95,9893,0.64,S2513
1,THARANIVENTHAN M S,Dravida Munnetra Kazhagam,497083,3016,500099,43.86,S2212
2,"GAJENDRAN, G.V.",All India Anna Dravida Munnetra Kazhagam,289650,1683,291333,25.55,S2212
3,DR GANESH KUMAR A ME PHD,Pattali Makkal Katchi,234538,2033,236571,20.75,S2212
4,"BAKIYALAKSHMI, K.",Naam Tamilar Katchi,65981,759,66740,5.85,S2212
5,"MANIGANDAN, V.",Independent,4787,21,4808,0.42,S2212
6,"GANESH KUMAR, U.",Independent,3809,3,3812,0.33,S2212
7,DURAI  M,Bahujan Samaj Party,3635,50,3685,0.32,S2212
8,"GAJENDRAN, J.",Independent,3393,7,3400,0.3,S2212
9,"KARVANNAN, K.",Independent,3032,4,3036,0.27,S2212
10,"GAJENDIRAN, E.",Independent,2612,1,2613,0.23,S2212
11,"KOTTAI VENKATESAN, M.",Independent,1893,15,1908,0.17,S2212
12,"SENTHIL KUMAR, D.",Independent,1469,6,1475,0.13,S2212
13,"SEKAR, N.",Independent,1397,3,1400,0.12,S2212
14,SAKTHIVEL A,Thakkam Katchi,1174,12,1186,0.1,S2212
15,"GANESH, P.",Independent,978,2,980,0.09,S2212
16,NAGARAJAN P,Veerath Thiyagi Viswanathadoss Thozhilalarkal Katchi,921,6,927,0.08,S2212
17,CAPTAIN SETTU M,Viro Ke Vir Indian Party,881,41,922,0.08,S2212
18,"JAISANKAR, M.",Independent,836,4,840,0.07,S2212
19,EZHIL ARASU M,Independent,741,12,753,0.07,S2212
20,BABU N,Independent,669,5,674,0.06,S2212
21,"DURUGAN, M.",United Republican Party of India,596,8,604,0.05,S2212
22,MOHMMAD SIDDIQ M H,Independent,525,3,528,0.05,S2212
23,"DHARANI, D.",Independent,466,2,468,0.04,S2212
24,"MANAVALAN, A.",Anna MGR Dravida Makkal Kalgam,433,47,480,0.04,S2212
25,"ARUL, M.",Independent,429,81,510,0.04,S2212
26,"MURUGESAN, D.",Independent,398,5,403,0.04,S2212
27,"ELLAPPAN, R.",Independent,375,3,378,0.03,S2212
28,"FEROZKHAN, A.",Independent,295,3,298,0.03,S2212
29,"DHAMODHARAN, G.",Independent,237,5,242,0.02,S2212
30,NOTA,None of the Above,9084,104,9188,0.81,S2212
1,NARESH GANPAT MHASKE,Shiv Sena,732109,2122,734231,56.09,S1325
2,RAJAN BABURAO VICHARE,Shiv Sena (Uddhav Balasaheb Thackrey),515013,2207,517220,39.51,S1325
3,SANTOSH BHIKAJI BHALERAO,Bahujan Samaj Party,10602,60,10662,0.81,S1325
4,ADV. GURUDEV NARSINGH SURYAWANSHI,Independent,3489,5,3494,0.27,S1325
5,MUKESH KAILASNATH TIWARI,Bhim Sena,2509,13,2522,0.19,S1325
6,JHA SUBHASH CHANDRA,Sardar Vallabhbhai Patel Party,2354,4,2358,0.18,S1325
7,DR. PIYUSH K. SAXENA,Independent,2292,1,2293,0.18,S1325
8,CHANDRAKANT VITTHAL SONAWANE,Independent,2245,4,2249,0.17,S1325
9,VIJAY DNYANOBA GHATE,Republican Bahujan Sena,1870,17,1887,0.14,S1325
10,IRFAN IBRAHIM SHAIKH,Independent,1867,8,1875,0.14,S1325
11,PRAMOD ANANDRAO DHUMAL,Independent,1785,1,1786,0.14,S1325
12,BHANWARLAL KHETMAL MEHTA,Hindu Samaj Party,1483,5,1488,0.11,S1325
13,UTTAM KISANRAO TIRPUDE,Peoples Party of India (Democratic),1349,5,1354,0.1,S1325
14,ARCHANA DINKAR GAIKWAD,Independent,1164,16,1180,0.09,S1325
15,SALIMA MUKTAR VASANI,Bahujan Maha Party,905,7,912,0.07,S1325
16,RAJIV KONDIBA BHOSALE,Independent,878,8,886,0.07,S1325
17,RAHUL JAGBIRSINGH MEHAROLIYA,Bahujan Republican  Socialist Party,818,0,818,0.06,S1325
18,RAJENDRA RAMCHANDRA SANKHE,Bharatheeya Jawan Kisan Party,759,8,767,0.06,S1325
19,KHAJASAB RASULSAB MULLA,Independent,646,2,648,0.05,S1325
20,SANJAY MANOHAR MORE,Independent,639,4,643,0.05,S1325
21,MALLIKARJUN SAYBANNA PUJARI,Independent,597,2,599,0.05,S1325
22,SAWALE DATTATRAY SITARAM,Independent,529,2,531,0.04,S1325
23,SURENDRAKUMAR K. JAIN,Independent,438,2,440,0.03,S1325
24,SIDDHANT CHHABAN SHIRSAT,Independent,319,5,324,0.02,S1325
25,NOTA,None of the Above,17768,133,17901,1.37,S1325
1,SACHITHANANTHAM R,Communist Party of India  (Marxist),667391,2758,670149,58.29,S2222
2,MOHAMED MUBARAK M A,All India Anna Dravida Munnetra Kazhagam,225492,836,226328,19.69,S2222
3,THILGABAMA M,Pattali Makkal Katchi,111013,1490,112503,9.79,S2222
4,KAILAI RAJAN D,Naam Tamilar Katchi,96891,954,97845,8.51,S2222
5,RAJKUMAR R,Independent,4410,6,4416,0.38,S2222
6,NATCHIMUTHU S,Bahujan Samaj Party,4231,53,4284,0.37,S2222
7,DINESHKUMAR S,All India Youth Development Party,2411,23,2434,0.21,S2222
8,MURUGESAN (A) VISHNU MURUGESAN C,Independent,2004,4,2008,0.17,S2222
9,ANGUCHAMY M,Independent,1286,4,1290,0.11,S2222
10,SURESH K,Independent,1254,3,1257,0.11,S2222
11,ARUMUGAM R,Independent,1078,11,1089,0.09,S2222
12,SABARINATH S,Independent,1001,10,1011,0.09,S2222
13,ANBUROSE D,Independent,997,15,1012,0.09,S2222
14,PALANISAMY K,Independent,941,8,949,0.08,S2222
15,SATHISH KANNA G T,Independent,914,12,926,0.08,S2222
16,NOTA,None of the Above,21860,260,22120,1.92,S2222
1,DEVESH SHAKYA,Samajwadi Party,474263,1545,475808,47.09,S2422
2,RAJVEER SINGH (RAJU BHAIYA),Bharatiya Janata Party,446748,1008,447756,44.32,S2422
3,MOHAMMAD IRFAN ADVOCATE,Bahujan Samaj Party,71407,178,71585,7.08,S2422
4,ANUPAM KUMAR,Kisan Kranti Dal,3944,5,3949,0.39,S2422
5,KAILASH KUMAR,Independent,1728,0,1728,0.17,S2422
6,DANVEER,Independent,1261,4,1265,0.13,S2422
7,UDAY VEER SINGH,Peoples Party of India (Democratic),985,7,992,0.1,S2422
8,ASHOK KUMAR,Independent,777,3,780,0.08,S2422
9,VIABHAV MISHRA,Bhartiya Shakti Chetna Party,742,5,747,0.07,S2422
10,AMAR SINGH,Independent,609,6,615,0.06,S2422
11,NOTA,None of the Above,5145,11,5156,0.51,S2422
1,DR.MALLU RAVI,Indian National Congress,459259,5813,465072,38.14,S2912
2,BHARATH  PRASAD POTHUGANTI,Bharatiya Janata Party,364898,5760,370658,30.4,S2912
3,DR.R.S.PRAVEEN KUMAR,Bharat Rashtra Samithi,319216,2127,321343,26.36,S2912
4,AMBOJU RAVI,Alliance of Democratic Reforms Party,12544,10,12554,1.03,S2912
5,BESAMOLLA  YOSEF,Bahujan Samaj Party,7138,80,7218,0.59,S2912
6,PILLELA SRIKANTH,Independent,6403,1,6404,0.53,S2912
7,BUDDHULA SRINIVAS,Independent,4358,3,4361,0.36,S2912
8,PALADHI NAGARAJU,Independent,4056,2,4058,0.33,S2912
9,AMARNATH,India Praja Bandhu Party,3703,6,3709,0.3,S2912
10,PULJALA BALAIAH,Independent,3582,2,3584,0.29,S2912
11,GALIMUDI GEETHA,Independent,3145,2,3147,0.26,S2912
12,KARNE. SHIREESHA @ BARRELAKKA,Independent,3037,50,3087,0.25,S2912
13,PAKIRA RAMULU,Independent,2833,6,2839,0.23,S2912
14,BIKSHAPATHI LANDA,Independent,1980,1,1981,0.16,S2912
15,AYYAPPA SUNIL,Rashtriya Praja Congress  (Secular),1224,3,1227,0.1,S2912
16,GADDAM VIJAY,Bahujan Mukti Party,1006,3,1009,0.08,S2912
17,PRASANGI,Pyramid Party of India,892,0,892,0.07,S2912
18,VAGGU VINAY,Vidhyarthula Rajakiya Party,768,2,770,0.06,S2912
19,DASARI BHARATHI,Viduthalai Chiruthaigal Katchi,722,8,730,0.06,S2912
20,NOTA,None of the Above,4511,69,4580,0.38,S2912
1,DR SHRIKANT EKNATH SHINDE,Shiv Sena,587921,1715,589636,56.38,S1324
2,VAISHALI DAREKAR - RANE,Shiv Sena (Uddhav Balasaheb Thackrey),379236,1256,380492,36.39,S1324
3,MO. SAHABUDDIN SHAIKH SULEMANI THAKUR,Vanchit Bahujan  Aaghadi,18697,44,18741,1.79,S1324
4,PRASHANT RAMESH INGLE,Bahujan Samaj Party,11285,56,11341,1.08,S1324
5,AMIT UPADHYAY,Right to Recall Party,4185,20,4205,0.4,S1324
6,ARUN BHAURAO NITURE,Rashtriya Kisan Bahujan Party,2751,2,2753,0.26,S1324
7,AMRISH RAJ MORAJKAR,Independent,2616,4,2620,0.25,S1324
8,ASHWINI AMOL KENDRE,Independent,2461,7,2468,0.24,S1324
9,NAFIS AHMED ANSARI,Independent,1997,3,2000,0.19,S1324
10,SUSHILA KASHINATH KAMBLE,Bahujan Samaj Party  (Ambedkar),1847,11,1858,0.18,S1324
11,ABHIJIT WAMANRAO BICHUKALE,Independent,1823,1,1824,0.17,S1324
12,AJAY SHYAM MORYA,Independent,1798,4,1802,0.17,S1324
13,SAMBHAJI JAGANNATH JADHAV,Sanyukt Bharat Paksh,1607,2,1609,0.15,S1324
14,CHANDRAKANT RAMBHAJI MOTE,Independent,1378,2,1380,0.13,S1324
15,POONAM JAGANNATH BAISANE,Bahujan Republican  Socialist Party,1376,5,1381,0.13,S1324
16,HINDURAO DADU PATIL,Rashtriya Maratha Party,1236,7,1243,0.12,S1324
17,GAWALI PRAVIN SHIVAJI,Apni Prajahit Party,1080,2,1082,0.1,S1324
18,ARUN VAMAN JADHAV,Independent,1077,5,1082,0.1,S1324
19,SHRIDHAR NARAYAN SALVE,Bhim Sena,1068,4,1072,0.1,S1324
20,SHRIKANT SHIVAJI VANJARE,Peoples Party of India (Democratic),806,2,808,0.08,S1324
21,PRAJAKTA NILESH YELVE,Independent,780,3,783,0.07,S1324
22,DNYANESHWAR LOKHANDE MAHARAJ,Independent,738,3,741,0.07,S1324
23,ADV. HITESH JAIKISHAN JESWANI,Independent,712,3,715,0.07,S1324
24,MOHAMMAD YUSUF KHAN,Independent,648,5,653,0.06,S1324
25,RAKESH KUMAR DHISULAL JAIN,Independent,599,3,602,0.06,S1324
26,SHIVA KRISHNAMURTI IYER,Independent,435,2,437,0.04,S1324
27,SALIMUDDIN KHALILUDDIN SHAIKH,Independent,370,1,371,0.04,S1324
28,DR. SACHIN SAHEBRAO PATIL,Independent,346,5,351,0.03,S1324
29,NOTA,None of the Above,11603,83,11686,1.12,S1324
1,BHAJAN LAL JATAV,Indian National Congress,525379,4632,530011,53.64,S2010
2,INDU DEVI,Bharatiya Janata Party,426798,4268,431066,43.62,S2010
3,VIKRAM SINGH,Bahujan Samaj Party,14005,107,14112,1.43,S2010
4,RAMKHILADI DHOVI,Independent,5426,47,5473,0.55,S2010
5,NOTA,None of the Above,7402,58,7460,0.75,S2010
1,SHATRUGHAN PRASAD SINHA,All India Trinamool Congress,603105,2540,605645,46.53,S2540
2,SURENDRAJEET SINGH AHLUWALIA,Bharatiya Janata Party,544077,2004,546081,41.96,S2540
3,JAHANARA KHAN,Communist Party of India  (Marxist),105454,510,105964,8.14,S2540
4,DIPIKA BAURI,Independent,10623,24,10647,0.82,S2540
5,SUNNY KUMAR SAH,Bahujan Samaj Party,8546,29,8575,0.66,S2540
6,SUJIT PAL,Independent,4749,11,4760,0.37,S2540
7,AMARNATH CHOWDHURY,Socialist Unity Centre Of India (COMMUNIST),4330,28,4358,0.33,S2540
8,NOTA,None of the Above,15448,62,15510,1.19,S2540
1,DUSHYANT SINGH,Bharatiya Janata Party,861850,3526,865376,60.88,S2025
2,URMILA JAIN “BHAYA”,Indian National Congress,492342,2045,494387,34.78,S2025
3,CHANDRA SINGH KIRAD,Bahujan Samaj Party,12252,33,12285,0.86,S2025
4,RAVI RAJ SINGH,Independent,10231,43,10274,0.72,S2025
5,BHUVANESH KUMAR,Right to Recall Party,9324,21,9345,0.66,S2025
6,BABULAL,Independent,7668,24,7692,0.54,S2025
7,PANKAJ PAJANTORIVALA,Independent,5927,18,5945,0.42,S2025
8,NOTA,None of the Above,15958,69,16027,1.13,S2025
1,ANNPURNA DEVI,Bharatiya Janata Party,787185,4472,791657,57.79,S275
2,VINOD KUMAR SINGH,Communist Party of India  (Marxist-Leninist)  (Liberation),410945,3698,414643,30.27,S275
3,MANOJ KUMAR,Independent,28310,302,28612,2.09,S275
4,JAI PRAKASH VERMA,Independent,22843,380,23223,1.7,S275
5,SITAN RABIDAS,Bahujan Samaj Party,13067,107,13174,0.96,S275
6,SURENDRA KUMAR AGRAWAL,Independent,9646,10,9656,0.7,S275
7,SAHADAT ANSARI,Independent,8217,15,8232,0.6,S275
8,JAYNARAYAN DAS,Bahujan Mukti Party,6701,37,6738,0.49,S275
9,AKLESHWAR SAW,Lokhit Adhikar Party,5574,27,5601,0.41,S275
10,JITLAL KISKU,Independent,5299,34,5333,0.39,S275
11,MD. SAGIR,Independent,5041,3,5044,0.37,S275
12,AJAY KRISHNA,Moolniwasi Samaj Party,4526,15,4541,0.33,S275
13,RAJESH,Independent,4230,3,4233,0.31,S275
14,RAMESHWAR PRASAD YADAV,Independent,4227,2,4229,0.31,S275
15,ASHISH KUMAR,Right to Recall Party,2892,4,2896,0.21,S275
16,NOTA,None of the Above,42089,63,42152,3.08,S275
1,BALWANT BASWANT WANKHADE,Indian National Congress,524136,2135,526271,44.84,S137
2,NAVNEET RAVI RANA,Bharatiya Janata Party,504806,1734,506540,43.16,S137
3,DINESH GANESHDAS BUB,Prahar Janshakti Party,84985,315,85300,7.27,S137
4,ANANDRAJ YASHWANT AMBEDKAR,Republican Sena,18713,80,18793,1.6,S137
5,KISHOR BHIMRAO LABADE,Independent,4522,2,4524,0.39,S137
6,SANJAYKUMAR FATTESINGH GADGE,Bahujan Samaj Party,4485,28,4513,0.38,S137
7,SUMITRA SAHEBRAO GAIKWAD,Independent,2686,4,2690,0.23,S137
8,ARUN YASHWANTRAO BHAGAT,Independent,2086,2,2088,0.18,S137
9,KISHOR DNYANESHWAR TAYDE,Independent,2070,2,2072,0.18,S137
10,SURAJ DHANRAJ NAGDVANE,Independent,1815,3,1818,0.15,S137
11,GAUTAM ALIAS ANANTA RAMDAS INGALE,Independent,1570,0,1570,0.13,S137
12,PRAMOD RAMKRUSHNA CHOURPAGAR,Independent,1306,1,1307,0.11,S137
13,ANIL THAWARE ALIAS DR. ANILKUMAR NAGBUDDHA,Independent,1206,0,1206,0.1,S137
14,SURESH PUNDLIK MESHRAM,Independent,1051,1,1052,0.09,S137
15,SATISH YASHWANTRAO GEDAM,Independent,942,1,943,0.08,S137
16,MANOHAR KRUSHNAJI KURHADE,Independent,871,0,871,0.07,S137
17,DIGAMBAR WAMAN BHAGAT,Naki Bharatiya Ekta Party,760,2,762,0.06,S137
18,ENGI. AVINASH HARISHCHANDRA DHANAWATE,Peoples Party of India (Democratic),725,5,730,0.06,S137
19,HIMMAT BHIMRAO DHOLE,Independent,668,2,670,0.06,S137
20,SUSHAMA GAJANAN AWACHAR,Jay Vidarbha Party,656,3,659,0.06,S137
21,GANESH NANAJI RAMTEKE,Akhil Bhartiya Parivar Party,624,5,629,0.05,S137
22,MANKAR DNYANESHWAR KASHIRAO,Independent,538,1,539,0.05,S137
23,TARA SURESH WANKHADE,Independent,526,1,527,0.04,S137
24,SHRIKRUSHNA SAKHARAMJI KSHIRSAGAR,Independent,508,2,510,0.04,S137
25,ADV. RAJU MADHUKARRAO KALANE,Bahujan Bharat Party,495,0,495,0.04,S137
26,BHARAT CHAMPATRAO YANGAD,Independent,441,0,441,0.04,S137
27,VARSHA BHAGAWANTRAO BHAGAT,Independent,440,3,443,0.04,S137
28,NARENDRA BABULAL KATHANE,Desh Janhit Party,422,0,422,0.04,S137
29,PRABHAKAR PANDURANG BHATKAR,Independent,365,0,365,0.03,S137
30,ADV. PRUTHVISAMRAT MUKINDRAO DIPWANSH,Independent,335,2,337,0.03,S137
31,BHAURAO SAMPATRAO WANKHADE,All India Forward Bloc,328,1,329,0.03,S137
32,GHAZI SAADUDDIN ZAHEER AHMED,Rashtriya Ulama Council,325,6,331,0.03,S137
33,RAVI GUNWANTRAO WANKHADE,Independent,286,2,288,0.02,S137
34,SONALI SANJAY MESHRAM,Independent,270,2,272,0.02,S137
35,SANDEEP BABULAL MESHRAM,Independent,257,0,257,0.02,S137
36,RAJESH TULSHIRAM KHADE,Independent,239,0,239,0.02,S137
37,RAJU MAHADEVRAO SONONE,Independent,230,2,232,0.02,S137
38,NOTA,None of the Above,2517,27,2544,0.22,S137
1,AJENDRA SINGH LODHI,Samajwadi Party,490003,680,490683,44,S2447
2,KUNWAR PUSHPENDRA SINGH CHANDEL,Bharatiya Janata Party,487373,681,488054,43.76,S2447
3,NIRDOSH KUMAR DIXIT,Bahujan Samaj Party,94564,132,94696,8.49,S2447
4,ANUPAM KUMAR TRIPATHI,Bhartiya Shakti Chetna Party,6401,6,6407,0.57,S2447
5,BRIJESH KUMAR PAL,Rashtra Uday Party,4516,11,4527,0.41,S2447
6,BHUVANENDRA NARAYAN SINGH,Independent,4315,5,4320,0.39,S2447
7,SANTOSH KUMAR,Independent,3776,1,3777,0.34,S2447
8,RAJESH SINGH,Independent,3605,2,3607,0.32,S2447
9,SURESH KUMAR,Eklavya Samaj Party,2181,0,2181,0.2,S2447
10,SANJIV KUMAR,Spashtwadi Jan Aadhar Party,2003,0,2003,0.18,S2447
11,DHARMRAJ,Al-Hind Party,1589,2,1591,0.14,S2447
12,NOTA,None of the Above,13442,11,13453,1.21,S2447
1,PARBHUBHAI NAGARBHAI VASAVA,Bharatiya Janata Party,757787,6163,763950,57.04,S0623
2,CHAUDHARY SIDDHARTH AMARSINH,Indian National Congress,526054,7643,533697,39.85,S0623
3,REKHABEN HARSINGBHAI CHAUDHARI,Bahujan Samaj Party,15872,272,16144,1.21,S0623
4,NOTA,None of the Above,24762,780,25542,1.91,S0623
1,ANTO ANTONY,Indian National Congress,360957,6666,367623,39.98,S1117
2,DR.T.M.THOMAS ISSAC,Communist Party of India  (Marxist),297888,3616,301504,32.79,S1117
3,ANIL K.ANTONY,Bharatiya Janata Party,231172,3234,234406,25.49,S1117
4,ADV.P.K.GEETHAKRISHNAN,Bahujan Samaj Party,3918,54,3972,0.43,S1117
5,JOY P.MATHEW,People's Party of India(secular),1173,8,1181,0.13,S1117
6,K.C.THOMAS,Independent,1080,21,1101,0.12,S1117
7,ADV.HARIKUMAR M.K.,Ambedkarite Party of India,735,27,762,0.08,S1117
8,ANOOP V.,Independent,557,52,609,0.07,S1117
9,NOTA,None of the Above,8268,143,8411,0.91,S1117
1,LAXMIKANT PAPPU NISHAD,Samajwadi Party,497488,1207,498695,45.7,S2462
2,PRAVIN KUMAR NISHAD,Bharatiya Janata Party,405611,914,406525,37.25,S2462
3,NADEEM ASHRAF,Bahujan Samaj Party,150549,263,150812,13.82,S2462
4,DHEERAJ SRIVASTAV,Pragatisheel Samaj Party,5135,5,5140,0.47,S2462
5,RAM KRISHNA DWIVEDI,Independent,4509,0,4509,0.41,S2462
6,SATYVANT PRATAP SINGH,Independent,4351,7,4358,0.4,S2462
7,KULDEEP,Sardar Patel Siddhant Party,3591,4,3595,0.33,S2462
8,MITRASEN,Independent,2535,9,2544,0.23,S2462
9,RAJENDRA YADAV URF COLONEL SAHAB,Sarvjan Awaz Party,2229,10,2239,0.21,S2462
10,ANAND KUMAR GAUTAM,Independent,1840,10,1850,0.17,S2462
11,SUBHASH CHANDRA DUBEY,Naki Bharatiya Ekta Party,1702,6,1708,0.16,S2462
12,NOTA,None of the Above,9210,17,9227,0.85,S2462
1,DM KATHIR ANAND,Dravida Munnetra Kazhagam,566435,2257,568692,50.35,S228
2,AC SHANMUGAM,Bharatiya Janata Party,350956,2034,352990,31.25,S228
3,DR S PASUPATHI,All India Anna Dravida Munnetra Kazhagam,116964,718,117682,10.42,S228
4,D MAHESH ANAND,Naam Tamilar Katchi,52707,577,53284,4.72,S228
5,A NATARAJAN,Bharatiya Praja Aikyata Party,3982,23,4005,0.35,S228
6,SHANMUGAVELU,Independent,3570,6,3576,0.32,S228
7,MANSOOR ALI KHAN,Independent,2769,35,2804,0.25,S228
8,SYED ALI D,Independent,2121,3,2124,0.19,S228
9,P SHANMUGAM,Independent,2037,2,2039,0.18,S228
10,NAGARAJ P,Independent,1948,11,1959,0.17,S228
11,K JAYAMANI,Bahujan Samaj Party,1684,18,1702,0.15,S228
12,D SARAVANAN,Independent,1497,0,1497,0.13,S228
13,MP SHANMUGAM,Independent,859,9,868,0.08,S228
14,N SIVAKUMAR,Independent,701,0,701,0.06,S228
15,AFROSE,Independent,672,1,673,0.06,S228
16,A BEEMARAO MILINTHAR,United Republican Party of India,667,3,670,0.06,S228
17,DR S JAYARAJ,Independent,659,2,661,0.06,S228
18,K SHANMUGAM,Independent,601,15,616,0.05,S228
19,V KALIAPERUMAL,Ganasangam Party of India,594,6,600,0.05,S228
20,G SHANMUGAM,Independent,560,12,572,0.05,S228
21,PP JAYAPRAKASH,Independent,455,6,461,0.04,S228
22,PASUPATHI,Independent,407,8,415,0.04,S228
23,S WILLIAM SATHYARAJ,Tamil Manila Murpokku Dravida Kazhagam,373,4,377,0.03,S228
24,M BABU,Independent,303,3,306,0.03,S228
25,B JAGAN,Independent,282,3,285,0.03,S228
26,AHMED RAASHID PALLIMIRA,Independent,271,2,273,0.02,S228
27,SHANMUGASUNDARAM,Independent,250,1,251,0.02,S228
28,C MADHAVAN,Independent,201,1,202,0.02,S228
29,T JOHNSON,Independent,174,0,174,0.02,S228
30,E RAJKUMAR,Independent,129,4,133,0.01,S228
31,C RAMACHANDHIRAN,Independent,128,2,130,0.01,S228
32,NOTA,None of the Above,8669,67,8736,0.77,S228
1,ASIT KUMAR MAL,All India Trinamool Congress,851209,4424,855633,55.98,S2541
2,PIYA SAHA,Bharatiya Janata Party,525463,2917,528380,34.57,S2541
3,SHYAMALI PRADHAN,Communist Party of India  (Marxist),98819,564,99383,6.5,S2541
4,ATUL CHANDRA BAURI,Independent,7811,18,7829,0.51,S2541
5,DR MANIK CHANDRA PRODHAN,Bahujan Samaj Party,7011,28,7039,0.46,S2541
6,SHANTA DAS,Mulnibasi Party of India,3633,7,3640,0.24,S2541
7,BIJOY DOLUI,Socialist Unity Centre Of India (COMMUNIST),2774,18,2792,0.18,S2541
8,MANTU DHIBAR,Hindustan Shakti Sena,2048,4,2052,0.13,S2541
9,NOTA,None of the Above,21640,82,21722,1.42,S2541
1,AZAD KIRTI JHA,All India Trinamool Congress,717069,3598,720667,47.99,S2539
2,DILIP GHOSH,Bharatiya Janata Party,579609,3077,582686,38.8,S2539
3,SUKRITI GHOSAL,Communist Party of India  (Marxist),152851,978,153829,10.24,S2539
4,LUXMI NARAYAN KORA,Independent,7138,4,7142,0.48,S2539
5,PRABHU NATH SAH,Bahujan Samaj Party,6822,34,6856,0.46,S2539
6,TASBIRUL ISLAM,Socialist Unity Centre Of India (COMMUNIST),3450,19,3469,0.23,S2539
7,REENA LEONG,Independent,3100,11,3111,0.21,S2539
8,MIR SAKIMUDDIN,The National Road Map Party of India,2413,5,2418,0.16,S2539
9,NOTA,None of the Above,21532,63,21595,1.44,S2539
1,KHAGEN MURMU,Bharatiya Janata Party,525109,1914,527023,37.18,S257
2,PRASUN BANERJEE,All India Trinamool Congress,448234,1081,449315,31.7,S257
3,ALAM MOSTAQUE,Indian National Congress,384063,701,384764,27.14,S257
4,JATISH KISKU,Independent,8680,3,8683,0.61,S257
5,MONATAN HEMBRAM,Independent,7927,6,7933,0.56,S257
6,SWAPAN MAHATO,Independent,7235,2,7237,0.51,S257
7,SANATAN RISHI,Bahujan Samaj Party,5624,8,5632,0.4,S257
8,JOSEPH KISKU,Ambedkarite Party of India,4637,0,4637,0.33,S257
9,MONJU HEMBROM,Independent,3535,3,3538,0.25,S257
10,MD FARUQUE HOSSAIN,Independent,3374,1,3375,0.24,S257
11,SOMNATH DAS,Bharatiya Nyay-Adhikar Raksha Party,3157,7,3164,0.22,S257
12,SUBHASH BARMAN,Kamatapur People’s Party (United),2019,0,2019,0.14,S257
13,KALICHARAN ROY,Socialist Unity Centre Of India (COMMUNIST),1286,7,1293,0.09,S257
14,MD SOHEL,All India Secular Front,1090,2,1092,0.08,S257
15,NARESH PAL,Jan Sangh Party,593,3,596,0.04,S257
16,NOTA,None of the Above,7257,31,7288,0.51,S257
1,VISHAL (DADA) PRAKASHBAPU PATIL,Independent,569651,2015,571666,48.91,S1344
2,SANJAY (KAKA) PATIL,Bharatiya Janata Party,469392,2221,471613,40.35,S1344
3,CHANDRAHAR SUBHASH PATIL,Shiv Sena (Uddhav Balasaheb Thackrey),60115,745,60860,5.21,S1344
4,ALLAUDDIN HAYATCHAND KAZI,Independent,9269,13,9282,0.79,S1344
5,PRAKASH SHIVAJIRAO SHENDGE,Independent,8150,101,8251,0.71,S1344
6,PANDURANG RAOSAHEB BHOSALE,Bharatheeya Jawan Kisan Party,5518,47,5565,0.48,S1344
7,TIPUSULATAN SIKANDAR PATAVEGAR,Bahujan Samaj Party,5502,58,5560,0.48,S1344
8,MAHESH YASHWANT KHARADE,Swabhimani Paksha,5491,30,5521,0.47,S1344
9,RAVINDRA CHANDAR SOLANKAR,Independent,3649,9,3658,0.31,S1344
10,ANAND SHANKAR NALAGE,Baliraja Party,3531,9,3540,0.3,S1344
11,SHASHIKANT GAUTAM DESHMUKH,Independent,3143,12,3155,0.27,S1344
12,SATISH LALITA KRISHNA KADAM,Hindustan Janta Party,2851,8,2859,0.24,S1344
13,SUWARNATAI SUDHAKAR GAYAKWAD,Independent,1925,12,1937,0.17,S1344
14,DATTATRAY PANDIT PATIL,Independent,1468,1,1469,0.13,S1344
15,TOUHID ILAHI MOMIN,Independent,1460,0,1460,0.12,S1344
16,AJIT DHANAJI KHANDARE,Independent,1380,18,1398,0.12,S1344
17,BANDAGAR NANASO BALASO,Independent,1292,8,1300,0.11,S1344
18,JALINDAR MACHINDRA THOMAKE,Independent,1257,3,1260,0.11,S1344
19,SANGRAM RAJARAM MORE,Independent,1004,7,1011,0.09,S1344
20,DR AKASH VHATKAR,Independent,803,11,814,0.07,S1344
21,NOTA,None of the Above,6512,53,6565,0.56,S1344
1,SHIV PAL SINGH PATEL (DR. S P SINGH),Samajwadi Party,439836,2096,441932,46.65,S2439
2,SANGAM LAL GUPTA,Bharatiya Janata Party,374208,1518,375726,39.66,S2439
3,PRATHMESH MISHRA 'SENANI',Bahujan Samaj Party,79872,272,80144,8.46,S2439
4,SANDEEP SINGH,National Jan Dal,5270,16,5286,0.56,S2439
5,ARUN KUMAR PANDEY,Hindustan Samaj Party,4984,7,4991,0.53,S2439
6,SHIV RAM SHARMA,Moulik Adhikar Party,4709,2,4711,0.5,S2439
7,AMAR SINGH,Independent,4135,3,4138,0.44,S2439
8,SUNIL CHANDRA PAL,Rashtra Uday Party,3337,3,3340,0.35,S2439
9,AJEET PRATAP,Independent,2581,0,2581,0.27,S2439
10,VIJAY SINGH,Sanatan Sanskriti Raksha Dal,2457,2,2459,0.26,S2439
11,RISHI PATEL,Apna Dal (Kamerawadi),2425,4,2429,0.26,S2439
12,MAHESH KUMAR PRAJAPATI,Samajhdar Party,1963,1,1964,0.21,S2439
13,DHANANJAY,Independent,1622,1,1623,0.17,S2439
14,GEETA DEVI,Bhartiya Lokmat Rashtrwadi Party,1582,12,1594,0.17,S2439
15,RAMSIDDH YADAV URF R.S.YADAV,Manavtawadi Samaj Party,1326,1,1327,0.14,S2439
16,SUNIL KUMAR MISHRA,Independent,1134,2,1136,0.12,S2439
17,SHANKAR SUMAN TIVARI,Independent,1128,1,1129,0.12,S2439
18,DURGESH KUMAR,Rastriya Atal Janta Party,1113,3,1116,0.12,S2439
19,RAM KUMAR YADAV,Socialist Unity Centre Of India (COMMUNIST),1070,1,1071,0.11,S2439
20,SHIV PAL PATEL,Independent,1025,5,1030,0.11,S2439
21,DHARMENDRA TIWARI,Log Party,992,1,993,0.1,S2439
22,JOKHU PATEL,Sardar Patel Siddhant Party,969,2,971,0.1,S2439
23,SHRAWAN KUMAR TRIPATHI,Independent,849,2,851,0.09,S2439
24,DHYAN SINGH,Independent,675,3,678,0.07,S2439
25,PRAMOD KUMAR,Independent,672,2,674,0.07,S2439
26,MOHRAM ALI,Independent,501,2,503,0.05,S2439
27,NOTA,None of the Above,2869,22,2891,0.31,S2439
1,LUMBARAM,Bharatiya Janata Party,793705,3078,796783,54.91,S2018
2,VAIBHAV GEHLOT,Indian National Congress,592204,3036,595240,41.02,S2018
3,OTARAM,Bharat Adivasi Party,10077,32,10109,0.7,S2018
4,SHAKUR,Independent,9866,6,9872,0.68,S2018
5,MOTI LAL,Aazad Samaj Party (Kanshi Ram),4579,7,4586,0.32,S2018
6,RAMESH KUMAR BHANDARI,Independent,3909,1,3910,0.27,S2018
7,DEVARAM,Independent,3126,8,3134,0.22,S2018
8,KALURAM MEGHWAL,Independent,2258,5,2263,0.16,S2018
9,DINESH SINGH,Independent,2094,11,2105,0.15,S2018
10,TIKMA RAM BHATI,Bheem Tribal Congress,1653,7,1660,0.11,S2018
11,DALARAM,Independent,1493,15,1508,0.1,S2018
12,FOJARAM,Indian Peoples Green Party,1493,4,1497,0.1,S2018
13,NOTA,None of the Above,18439,20,18459,1.27,S2018
1,GURMEET SINGH MEET HAYER,Aam Aadmi Party,362791,1294,364085,36.06,S1912
2,SUKHPAL SINGH KHAIRA,Indian National Congress,190209,1316,191525,18.97,S1912
3,SIMRANJIT SINGH MANN,Shiromani Akali Dal (Amritsar)(Simranjit Singh Mann),186543,703,187246,18.55,S1912
4,ARVIND KHANNA,Bharatiya Janata Party,127781,472,128253,12.7,S1912
5,IQBAL SINGH JHUNDAN,Shiromani Akali Dal,62265,223,62488,6.19,S1912
6,MAKHAN SINGH,Bahujan Samaj Party,37604,127,37731,3.74,S1912
7,PARDEEP KUMAR,Apni Ekta Party,5131,8,5139,0.51,S1912
8,HARBHAJAN SINGH,Aazad Samaj Party (Kanshi Ram),3417,14,3431,0.34,S1912
9,SUKHWINDER SINGH,Independent,3225,0,3225,0.32,S1912
10,BALWINDER SINGH SEKHON,Independent,2562,10,2572,0.25,S1912
11,BALWINDER SINGH,Independent,2284,4,2288,0.23,S1912
12,JASWANT SINGH,Independent,2222,2,2224,0.22,S1912
13,PAPPU KUMAR,Independent,1826,1,1827,0.18,S1912
14,KRISHAN DEV,Punjab National Party,1803,12,1815,0.18,S1912
15,AMANPREET SINGH,Independent,1686,7,1693,0.17,S1912
16,RANGI KHAN,Aam Janta Party (India),1578,3,1581,0.16,S1912
17,JILE SINGH,Bhartiya Jan Samman Party,1546,2,1548,0.15,S1912
18,KAMAL KUMAR VERMA (BHASAUR),"Adarsh Janta Party,",1376,0,1376,0.14,S1912
19,CHANNVEER SINGH,Independent,1281,2,1283,0.13,S1912
20,JAGTAR SINGH,Nationalist Justice Party,1224,1,1225,0.12,S1912
21,VIJAY SYAL,Independent,1144,1,1145,0.11,S1912
22,HARPREET KAUR,India Greens Party,1095,10,1105,0.11,S1912
23,RAJA SINGH,Independent,1037,3,1040,0.1,S1912
24,NOTA,None of the Above,3773,47,3820,0.38,S1912
1,ARUN NEHRU,Dravida Munnetra Kazhagam,598003,5206,603209,53.42,S2225
2,CHANDRAMOHAN N D,All India Anna Dravida Munnetra Kazhagam,212495,1607,214102,18.96,S2225
3,PAARIVENDHAR T R,Bharatiya Janata Party,160606,1260,161866,14.33,S2225
4,THENMOZHI R,Naam Tamilar Katchi,112200,892,113092,10.02,S2225
5,MANI S,Independent,3950,1,3951,0.35,S2225
6,MADHU R,Independent,3498,10,3508,0.31,S2225
7,RENGARAJ S,Independent,3251,22,3273,0.29,S2225
8,ELANGOVAN R,Bahujan Samaj Party,3033,26,3059,0.27,S2225
9,VASUDEVAN A,Independent,1355,7,1362,0.12,S2225
10,ARUN NEHRU,Independent,1280,19,1299,0.12,S2225
11,LAKSHMANAN,Independent,1087,0,1087,0.1,S2225
12,PARY T,Independent,1077,4,1081,0.1,S2225
13,ANANDARAJU R,Independent,1009,6,1015,0.09,S2225
14,JAYAKUMAR K,Samaniya Makkal Nala Katchi,1003,3,1006,0.09,S2225
15,TAMILSELVAN M,Independent,872,6,878,0.08,S2225
16,THANGAMANI K,Independent,868,5,873,0.08,S2225
17,P K AMMAN G SIVAKUMAR,Independent,740,15,755,0.07,S2225
18,EBINESAN M,Independent,731,17,748,0.07,S2225
19,MURUGANANTHAM T,Independent,730,3,733,0.06,S2225
20,SUDHAKAR S,Independent,550,5,555,0.05,S2225
21,SAMBATH D,Independent,530,2,532,0.05,S2225
22,MUTHUKUMAR,Independent,467,2,469,0.04,S2225
23,VEERAMALAI K,Independent,449,2,451,0.04,S2225
24,NOTA,None of the Above,10075,247,10322,0.91,S2225
1,TAPIR GAO,Bharatiya Janata Party,140715,4866,145581,45.01,S022
2,BOSIRAM SIRAM,Indian National Congress,109433,5727,115160,35.6,S022
3,TAMAT GAMOH,Independent,26691,912,27603,8.53,S022
4,SOTAI KRI,Independent,13227,986,14213,4.39,S022
5,OMAK NITIK,Independent,9074,295,9369,2.9,S022
6,BANDEY MILI,Arunachal Democratic Party,6419,203,6622,2.05,S022
7,NOTA,None of the Above,4654,241,4895,1.51,S022
1,KANGNA RANAUT,Bharatiya Janata Party,527463,9559,537022,52.87,S082
2,VIKRAMADITYA SINGH,Indian National Congress,453760,8507,462267,45.51,S082
3,DR. PRAKASH CHAND BHARDWAJ,Bahujan Samaj Party,4320,73,4393,0.43,S082
4,NARENDER KUMAR,Rashtriya Devbhumi Party,2422,25,2447,0.24,S082
5,RAKHEE GUPTA,Independent,1014,37,1051,0.1,S082
6,SUBHASH MOHAN SNEHI,Independent,963,11,974,0.1,S082
7,VINAY KUMAR,Akhil Bhartiya Parivar Party,674,16,690,0.07,S082
8,MAHESH  SAINI,Himachal Janta Party,641,13,654,0.06,S082
9,DINESH KUMAR BHATI,Independent,375,6,381,0.04,S082
10,ASHUTOSH MAHANT,Independent,260,26,286,0.03,S082
11,NOTA,None of the Above,5586,59,5645,0.56,S082
1,SATABDI ROY,All India Trinamool Congress,714972,2989,717961,47,S2542
2,DEBTANU BHATTACHARYA,Bharatiya Janata Party,517761,2550,520311,34.06,S2542
3,MILTON RASHID,Indian National Congress,225572,688,226260,14.81,S2542
4,AMIY GHOSH,Independent,11950,8,11958,0.78,S2542
5,LAKSHMI HEMBROM,Ambedkarite Party of India,7677,10,7687,0.5,S2542
6,AYESHA KHATUN,Socialist Unity Centre Of India (COMMUNIST),6761,18,6779,0.44,S2542
7,RAJNATH SARKAR,Bahujan Samaj Party,5866,16,5882,0.39,S2542
8,SAURAV MUDI,Independent,4249,7,4256,0.28,S2542
9,ABDUL IMRAN,Independent,3823,9,3832,0.25,S2542
10,BISWAJIT MISHRA,All India Arya Mahasabha,3806,17,3823,0.25,S2542
11,MD. JAKIR HOSSAIN,Bharatiya National Janata Dal,2547,10,2557,0.17,S2542
12,DOLA SARKAR,Indian National Socialistic Action Forces,2027,6,2033,0.13,S2542
13,NOTA,None of the Above,14037,56,14093,0.92,S2542
1,DEVUSINH CHAUHAN,Bharatiya Janata Party,738609,5826,744435,63.31,S0617
2,KALUSINH DABHI,Indian National Congress,381656,5021,386677,32.88,S0617
3,SODHA SANJAYKUMAR PARVATSINH,Independent,6123,16,6139,0.52,S0617
4,BHAILALBHAI KALUBHAI PANDAV,Bahujan Samaj Party,6055,97,6152,0.52,S0617
5,PARMAR HITESHKUMAR PARSOTTAMBHAI,Independent,2730,11,2741,0.23,S0617
6,UPENDRAKUMAR VALLAVBHAI PATEL,Independent,2703,12,2715,0.23,S0617
7,PATEL ANILKUMAR BHAILALBHAI,Rashtriya Mahaswaraj Bhumi Party,2493,30,2523,0.21,S0617
8,SAIYAD KADARI MOHAMMAD SABIR ANVAR HUSAIN,Bhartiya Jan Nayak Party,1812,26,1838,0.16,S0617
9,INDIRADEVI HIRALAL VORA,Garib Kalyan Party,1126,9,1135,0.1,S0617
10,KAMLESHBHAI POPATBHAI PATEL,Bhartiya Jan Parishad,933,16,949,0.08,S0617
11,IMRANBHAI VANKAWALA,Right to Recall Party,924,4,928,0.08,S0617
12,KANTIYA DASRATH HARJIVANBHAI,New India United Party,789,3,792,0.07,S0617
13,NOTA,None of the Above,18444,380,18824,1.6,S0617
1,AMRARAM,Communist Party of India  (Marxist),645559,13741,659300,50.68,S205
2,SUMEDHANAND SARASWATI,Bharatiya Janata Party,574740,11664,586404,45.08,S205
3,SURESH PAREEK,Independent,10014,7,10021,0.77,S205
4,AMARCHAND,Bahujan Samaj Party,8293,326,8619,0.66,S205
5,VISHNU KUMAR NATRAJ,Independent,5796,7,5803,0.45,S205
6,RAVINDRA SINGH SHEKHAWAT,Independent,5775,250,6025,0.46,S205
7,ASHOK SEHRA,Ambedkarite Party of India,5333,49,5382,0.41,S205
8,DHIRENDRA  VERMA,Ummeed Party of India,2885,59,2944,0.23,S205
9,MAHESH KUMAR,Independent,1962,94,2056,0.16,S205
10,BENI PRASAD KAUSHIK (LATA),Rashtriya Sawarn Dal,1720,11,1731,0.13,S205
11,RAMESH SHARMA,Bhartiya Party,1516,33,1549,0.12,S205
12,VIJENDER MAHARIA,Bharatiya Yuva Jan Ekta Party,1421,30,1451,0.11,S205
13,OM PRAKASH,Independent,1182,42,1224,0.09,S205
14,BIRBALSINGH,Independent,1034,47,1081,0.08,S205
15,NOTA,None of the Above,7081,185,7266,0.56,S205
1,GANAPATHY RAJKUMAR P,Dravida Munnetra Kazhagam,565428,2772,568200,41.39,S2220
2,ANNAMALAI K,Bharatiya Janata Party,447608,2524,450132,32.79,S2220
3,SINGAI G RAMACHANDRAN,All India Anna Dravida Munnetra Kazhagam,235603,887,236490,17.23,S2220
4,KALAMANI JAGANATHAN,Naam Tamilar Katchi,82387,270,82657,6.02,S2220
5,VELMURUGAN K,Bahujan Samaj Party,2364,11,2375,0.17,S2220
6,SANJAYKUMAR S,Independent,1787,2,1789,0.13,S2220
7,ANNADURAI R,Independent,1767,5,1772,0.13,S2220
8,SURESH M,Independent,1472,2,1474,0.11,S2220
9,GOPALAKRISHNAN S,Independent,1196,3,1199,0.09,S2220
10,RAGHUL GANDHI K,Hindustan Janta Party,1170,6,1176,0.09,S2220
11,KARTHICK T,Independent,1070,3,1073,0.08,S2220
12,RAJKUMAR M,Independent,1067,1,1068,0.08,S2220
13,RAJKUMAR,Independent,1010,3,1013,0.07,S2220
14,RAJKUMAR G,Independent,888,4,892,0.06,S2220
15,SHANMUGAM K,Independent,881,1,882,0.06,S2220
16,KRISHNAN V,Independent,722,4,726,0.05,S2220
17,RAMACHANDRAN M,Independent,663,0,663,0.05,S2220
18,RAJAMANICKAM N,Independent,626,3,629,0.05,S2220
19,RAJKUMAR G B,Independent,607,4,611,0.04,S2220
20,KUMAR A,Ganasangam Party of India,548,3,551,0.04,S2220
21,SANGEETHA R,Naadaalum Makkal Katchi,491,1,492,0.04,S2220
22,RICHARD VINCENT,Viro Ke Vir Indian Party,489,3,492,0.04,S2220
23,SURIYAKUMAR K,Independent,443,4,447,0.03,S2220
24,ARUNKANTH V,Independent,432,6,438,0.03,S2220
25,ANANDHAKUMAR S,Rashtriya Samaj Paksha,417,2,419,0.03,S2220
26,RAMACHANDRAN R,Independent,368,1,369,0.03,S2220
27,MUTHUSAMY P P,Independent,368,1,369,0.03,S2220
28,PALANISAMYRAAJ M,Independent,313,3,316,0.02,S2220
29,PUSHPANANTHAM V,Tamizhaga Murpokku Makkal Katchi,303,2,305,0.02,S2220
30,DINESH K,Independent,284,1,285,0.02,S2220
31,PREMKUMAR P,Independent,281,2,283,0.02,S2220
32,RAVICHANDRAN,Independent,271,1,272,0.02,S2220
33,DURAISAMY A,Independent,263,3,266,0.02,S2220
34,ZAHIR HUSSAIN,Independent,259,1,260,0.02,S2220
35,BOOBALAN,Independent,252,1,253,0.02,S2220
36,NOORMUHAMAD A,Independent,232,2,234,0.02,S2220
37,PASUPATHI S,Independent,170,3,173,0.01,S2220
38,NOTA,None of the Above,11677,111,11788,0.86,S2220
1,THIRUMAAVALAVAN THOL,Viduthalai Chiruthaigal Katchi,501851,3233,505084,43.28,S2227
2,CHANDRAHASAN M,All India Anna Dravida Munnetra Kazhagam,399502,2028,401530,34.4,S2227
3,KARTHIYAYINI P,Bharatiya Janata Party,166114,2379,168493,14.44,S2227
4,JANCIRANI R,Naam Tamilar Katchi,65116,473,65589,5.62,S2227
5,NEELAMEGAM K,Bahujan Samaj Party,3177,26,3203,0.27,S2227
6,TAMILVENDHAN P,Independent,3043,19,3062,0.26,S2227
7,PERUMAL S,Independent,2231,8,2239,0.19,S2227
8,VETTRIVEL G,Independent,2039,2,2041,0.17,S2227
9,ARCHUNAN M A T,Independent,1833,3,1836,0.16,S2227
10,DHAMODHARAN S,Naadaalum Makkal Katchi,1628,14,1642,0.14,S2227
11,RATHA G,Independent,1273,7,1280,0.11,S2227
12,RAJAMANICKAM C,Independent,1068,19,1087,0.09,S2227
13,CHINNADURAI A,Independent,628,10,638,0.05,S2227
14,ELAVARASAN C,Independent,584,2,586,0.05,S2227
15,NOTA,None of the Above,8631,130,8761,0.75,S2227
1,AJAY BHATT,Bharatiya Janata Party,766397,6274,772671,61.03,S284
2,PRAKASH JOSHI,Indian National Congress,434916,3207,438123,34.61,S284
3,AKHTAR ALI,Bahujan Samaj Party,23276,179,23455,1.85,S284
4,AKHALESH KUMAR,Akhil Bhartiya Parivar Party,4871,31,4902,0.39,S284
5,HITESH PATHAK,Independent,4287,28,4315,0.34,S284
6,RAMESH KUMAR MAX,Independent,3271,29,3300,0.26,S284
7,AMAR SINGH SAINI,Peoples Party of India (Democratic),2963,24,2987,0.24,S284
8,JEEVAN CHANDRA UPRETI,Bharat Ki Lok Jimmedar Party,2292,18,2310,0.18,S284
9,SHIB SINGH,Uttarakhand Kranti Dal,1809,46,1855,0.15,S284
10,SURENDRA SINGH,Bhartiya Shakti Chetna Party,1655,18,1673,0.13,S284
11,NOTA,None of the Above,10227,198,10425,0.82,S284
1,UTKARSH VERMA  'MADHUR',Samajwadi Party,555277,2088,557365,45.94,S2428
2,AJAY KUMAR,Bharatiya Janata Party,521954,1082,523036,43.11,S2428
3,ANSHAY KALRA,Bahujan Samaj Party,110122,338,110460,9.1,S2428
4,SANDHYA JAISWAL,Parivartan Samaj Party,3093,3,3096,0.26,S2428
5,SATENDRA KUMAR MAURYA,Independent,2980,2,2982,0.25,S2428
6,OM NATH SINGH,Rashtriya Shoshit Samaj Party,2298,2,2300,0.19,S2428
7,NARESH SINGH BHADAURIYA,Independent,2107,4,2111,0.17,S2428
8,MUKESH KUMAR  (BHARTI),Rashtriya Vikalp Party,1266,3,1269,0.1,S2428
9,KHANJAN,Netaji Subhash Chander Bose Rashtriya Azad Party,1018,1,1019,0.08,S2428
10,DARWARI URF  DARWARI LAL  CHAUHAN,Janta Kranti Party,935,1,936,0.08,S2428
11,KM. PANCHSHEELA ANAND,Uttar Pradesh Republican Party,845,9,854,0.07,S2428
12,NOTA,None of the Above,7915,16,7931,0.65,S2428
1,DR. RAJ KUMAR CHABBEWAL,Aam Aadmi Party,302402,1457,303859,32.04,S195
2,YAMINI GOMAR,Indian National Congress,257936,1812,259748,27.39,S195
3,ANITA SOM PARKASH,Bharatiya Janata Party,198576,1418,199994,21.09,S195
4,SOHAN SINGH THANDAL,Shiromani Akali Dal,91503,286,91789,9.68,S195
5,RANJIT KUMAR,Bahujan Samaj Party,47975,239,48214,5.08,S195
6,JASWANT SINGH,Shiromani Akali Dal (Amritsar)(Simranjit Singh Mann),20680,243,20923,2.21,S195
7,JEEVAN SINGH TAMIL,Bahujan Dravida Party,4607,14,4621,0.49,S195
8,ROHIT KUMAR TINKU,Independent,2417,2,2419,0.26,S195
9,RAJESH,Democratic Bharatiya Samaj Party,2330,6,2336,0.25,S195
10,SONU SINGH PHAGWARA,Independent,1871,13,1884,0.2,S195
11,DAVINDER SINGH,Independent,1584,33,1617,0.17,S195
12,HARDEEP SINGH,Nationalist Justice Party,1403,22,1425,0.15,S195
13,RAJPAL NADALI,Bahujan Mukti Party,1138,2,1140,0.12,S195
14,BHIMRAO YASHWANT AMBEDKAR,Global Republican Party,1034,7,1041,0.11,S195
15,SATPAL,Independent,978,15,993,0.1,S195
16,DAVINDER KUMAR SAROYA,Samaj Bhalai Morcha,923,7,930,0.1,S195
17,NOTA,None of the Above,5453,99,5552,0.59,S195
1,DR. MANSUKH MANDAVIYA,Bharatiya Janata Party,625962,7156,633118,68.15,S0611
2,LALIT VASOYA,Indian National Congress,245677,4081,249758,26.89,S0611
3,N. P. RATHOD,Bahujan Samaj Party,10560,362,10922,1.18,S0611
4,NATHABHAI BHURABHAI ODEDRA,Independent,7164,132,7296,0.79,S0611
5,LAKHANSI ODEDARA,Viro Ke Vir Indian Party,3130,33,3163,0.34,S0611
6,SOLANKI JATIN DHIRUBHAI,Independent,2469,17,2486,0.27,S0611
7,SODHA HUSHENBHAI ALIBHAI,Independent,2432,3,2435,0.26,S0611
8,RATHOD CHANDUBHAI MOHANBHAI,Independent,1705,24,1729,0.19,S0611
9,SHEKHAVA NILESHKUMAR RAMJIBHAI,Samajwadi Party,1587,22,1609,0.17,S0611
10,SIDHHAPARA HARSUKHLAL JIVANBHAI,Log Party,1059,13,1072,0.12,S0611
11,MAHEMUDBHAI SAIYAD,Independent,1023,6,1029,0.11,S0611
12,JETHAVA BIPINKUMAR BHIKHALAL,Independent,786,11,797,0.09,S0611
13,NOTA,None of the Above,13004,559,13563,1.46,S0611
1,"JANARDAN SINGH ""SIGRIWAL""",Bharatiya Janata Party,527974,1559,529533,52.22,S0419
2,AAKASH KUMAR SINGH,Indian National Congress,425887,995,426882,42.09,S0419
3,TRIBHUWAN RAM,Peoples Party of India (Democratic),14830,8,14838,1.46,S0419
4,MADHUSUDAN SINGH,Bahujan Samaj Party,13359,43,13402,1.32,S0419
5,AKHILESHWAR PRASAD SINGH,All India Majlis-E-Ittehadul Muslimeen,7750,17,7767,0.77,S0419
6,NOTA,None of the Above,21662,25,21687,2.14,S0419
1,KARAN BHUSHAN SINGH,Bharatiya Janata Party,570436,827,571263,53.79,S2457
2,BHAGAT RAM,Samajwadi Party,422012,408,422420,39.77,S2457
3,NARENDRA PANDEY,Bahujan Samaj Party,44217,62,44279,4.17,S2457
4,ARUNIMA PANDEY,Independent,9230,20,9250,0.87,S2457
5,NOTA,None of the Above,14872,15,14887,1.4,S2457
1,Sasikanth Senthil,Indian National Congress,794608,2348,796956,56.21,S221
2,"Balaganapathy, V. Pon",Bharatiya Janata Party,224042,759,224801,15.86,S221
3,"Nallathambi, K.",Desiya Murpokku Dravida Kazhagam,223550,354,223904,15.79,S221
4,"Jagadesh Chander, M.",Naam Tamilar Katchi,120620,218,120838,8.52,S221
5,"Tamizhmadhi, D.",Bahujan Samaj Party,13772,38,13810,0.97,S221
6,"Ashok Priyadarshan, S.",Desiya Makkal Sakthi Katchi,2937,9,2946,0.21,S221
7,Malathi,Naadaalum Makkal Katchi,2829,24,2853,0.2,S221
8,"Mani, E.",Independent,2745,7,2752,0.19,S221
9,"Devandhran, M.",Anna MGR Dravida Makkal Kalgam,2001,7,2008,0.14,S221
10,"Manimaran, V.",Independent,1921,1,1922,0.14,S221
11,"Balakrishnan, K.",Independent,1685,5,1690,0.12,S221
12,"Bharathidasan, S.S.",Independent,1619,12,1631,0.12,S221
13,"Shakthivel, A.J.",Independent,1605,8,1613,0.11,S221
14,"Sivasankaran, V.",Independent,1105,5,1110,0.08,S221
15,NOTA,None of the Above,18908,70,18978,1.34,S221
1,DR. VIRENDRA KUMAR,Bharatiya Janata Party,713781,1269,715050,65.1,S126
2,KHUMAN URF PANKAJ AHIRWAR,Indian National Congress,311134,604,311738,28.38,S126
3,AHIRWAR DALLURAM,Bahujan Samaj Party,32604,69,32673,2.97,S126
4,AHIRWAR PANKAJ,Rashtriya Samaj Paksha,10147,11,10158,0.92,S126
5,SARJU PRASAD,Independent,5993,4,5997,0.55,S126
6,N.R. PRAJAPATI,Adarsh Nyay Rakshak Party,5475,9,5484,0.5,S126
7,BABULAL KHANGAR,Independent,4452,7,4459,0.41,S126
8,NOTA,None of the Above,12816,15,12831,1.17,S126
1,YOGENDER CHANDOLIYA,Bharatiya Janata Party,863255,3228,866483,58.26,U055
2,UDIT RAJ,Indian National Congress,574451,1183,575634,38.71,U055
3,VIJAY BAUDDH,Bahujan Samaj Party,11955,42,11997,0.81,U055
4,SURESH KUMAR,Peoples Party of India (Democratic),2869,1,2870,0.19,U055
5,SANJAY KUMAR SIWAL,Rashtriya Janshakti Party (Secular),2866,0,2866,0.19,U055
6,SUBHASH,Asankhya Samaj Party,2250,0,2250,0.15,U055
7,RAJENDER SOOD,Aam Janshakti Party,1468,10,1478,0.1,U055
8,PRAVEEN GAUTAM,Navarang Congress Party,1455,1,1456,0.1,U055
9,K M KAJAL,Public Political Party,1334,8,1342,0.09,U055
10,NARESH KUMAR,Independent,1270,5,1275,0.09,U055
11,ADVOCATE SATISH CHANDRA,Ambedkarite Party of India,1236,1,1237,0.08,U055
12,PARMENDRA MANJHI,Independent,1102,0,1102,0.07,U055
13,ADVOCATE DR. MAHENDER   SINGH CHURIYANA,Bahujan Dravida Party,1015,1,1016,0.07,U055
14,CHANDER PAL SONI,Independent,891,0,891,0.06,U055
15,ADITI,Independent,790,0,790,0.05,U055
16,ADV. KRUPAL,Prabuddha Republican Party,673,2,675,0.05,U055
17,NAND RAM BAGRI,Voters Party  International,638,0,638,0.04,U055
18,SHYAM BHARTEEY,Gareeb Aadmi Party,629,3,632,0.04,U055
19,HARI KISHAN (MECHANIC),Independent,547,1,548,0.04,U055
20,POOJA (BHAGTANI),Bharatiya Jan Jagriti Party,504,5,509,0.03,U055
21,NARESH KUMAR,Rashtriya Samaj Paksha,499,1,500,0.03,U055
22,PREETI,Saman Adhikar Party,495,8,503,0.03,U055
23,SATYA PRAKASH UTTRAKHANDI,Independent,433,1,434,0.03,U055
24,KHILKHILAKAR,Bahujan Shoshit Samaj Sangharsh Samta Party,372,1,373,0.03,U055
25,PRADEEP KUMAR,Independent,371,0,371,0.02,U055
26,PUSHPA NAGRA,Independent,353,0,353,0.02,U055
27,NOTA,None of the Above,8917,67,8984,0.6,U055
1,PATEL UMESHBHAI BABUBHAI,Independent,42469,54,42523,46.02,U031
2,LALUBHAI BABUBHAI PATEL,Bharatiya Janata Party,36243,55,36298,39.28,U031
3,KETAN DAHYABHAI PATEL,Indian National Congress,11237,21,11258,12.18,U031
4,UMESH PATEL,Navsarjan Bharat Party,545,0,545,0.59,U031
5,SAKIL LATIF KHAN,Independent,323,0,323,0.35,U031
6,IDRISH G MULLA,Independent,247,0,247,0.27,U031
7,PATEL UMESHBHAI BABU,Independent,238,0,238,0.26,U031
8,NOTA,None of the Above,977,1,978,1.06,U031
1,SRIBHARAT MATHUKUMILI,Telugu Desam,893884,13583,907467,65.42,S014
2,JHANSI LAKSHMI. BOTCHA.,Yuvajana Sramika Rythu Congress Party,397821,5399,403220,29.07,S014
3,P. SATYA REDDY,Indian National Congress,29430,837,30267,2.18,S014
4,K.A. PAUL,Praja Shanthi Party,7529,167,7696,0.55,S014
5,PEDAPENKI SIVA PRASADA RAO,Bahujan Samaj Party,6006,85,6091,0.44,S014
6,BIKKAVOLU. CHALAMAJI,Navarang Congress Party,4883,1,4884,0.35,S014
7,V.N. SATYA NARAYANA,Rashtriya Praja Congress  (Secular),2534,3,2537,0.18,S014
8,ARUNA SRI MURALA,Independent,1991,2,1993,0.14,S014
9,VASUPILLI SURESH,Independent,1931,2,1933,0.14,S014
10,SONDI KRISHNA.,Independent,1811,7,1818,0.13,S014
11,ANDUKURI VIJAYA BHASKAR,India Praja Bandhu Party,1098,11,1109,0.08,S014
12,DR. GANAPATHI KONGARAPU.,Republican Party of India (A),944,6,950,0.07,S014
13,BANNA. RAMESH,Dalita Bahujana Party,941,7,948,0.07,S014
14,P. SATYA VANI,Pyramid Party of India,875,7,882,0.06,S014
15,DURGA PRASAD. GUNTU,Bhartiya Rashtriya Dal,760,7,767,0.06,S014
16,CHAPPIDI RAMU,Independent,756,1,757,0.05,S014
17,M.G.M. KHAN,Independent,738,4,742,0.05,S014
18,SHANKAR DEVARA YADAV,Independent,656,5,661,0.05,S014
19,VENU MADHAV KARRI,Independent,646,1,647,0.05,S014
20,DR. ACHUTHA BALAJI YADAV (MURAPALA),Bharatha Chaitanya Yuvajana Party,628,10,638,0.05,S014
21,THOTA VENKATA SAI MUKUND,Praja Prasthanam Party,628,5,633,0.05,S014
22,PIDIDHI APPARAO,Independent,576,4,580,0.04,S014
23,G.A.N. ANAND,Independent,543,0,543,0.04,S014
24,VADDI. HARI GANESH,Independent,518,2,520,0.04,S014
25,JANARDHAN PONNADA.,Independent,499,1,500,0.04,S014
26,GANAPATHI. JAGADEESWARA RAO (JAGADEESH),Jai Maha Bharath Party,494,6,500,0.04,S014
27,JALADI VIJAYA KUMARI,Samajwadi Party,463,3,466,0.03,S014
28,CHINTADA SURYAM,Naba Bharata Nirmana Seva Party,443,5,448,0.03,S014
29,GANDIKOTA RAJESH,Navataram Party,392,1,393,0.03,S014
30,KOLLI NAGA RAJU,Independent,322,7,329,0.02,S014
31,METTA RAMA RAO,Independent,320,6,326,0.02,S014
32,LAGUDU. GOVINDA RAO,Independent,293,1,294,0.02,S014
33,MALLA SRAVANI,Independent,271,2,273,0.02,S014
34,NOTA,None of the Above,5171,142,5313,0.38,S014
1,KRIPANATH MALLAH,Bharatiya Janata Party,541220,3873,545093,47.53,S037
2,HAFIZ RASHID AHMED CHOUDHURY,Indian National Congress,524390,2343,526733,45.93,S037
3,SAHABUL ISLAM CHOUDHURY,All India United Democratic Front,29070,135,29205,2.55,S037
4,JIBESH DEB,Independent,7105,4,7109,0.62,S037
5,DEBOJYOTI NATH,Independent,5900,7,5907,0.52,S037
6,AHAD UDDIN,Rashtriya Ulama Council,4186,6,4192,0.37,S037
7,BINAY KRISHNA ROY,Independent,3621,7,3628,0.32,S037
8,DILIP KUMAR,Independent,2623,7,2630,0.23,S037
9,ROSID AHMED LASKAR,Independent,2600,1,2601,0.23,S037
10,MUZAKKIR HASAN LASKAR,Independent,2287,4,2291,0.2,S037
11,ABDUL BASIT TAPADAR,Independent,1912,11,1923,0.17,S037
12,GOPAL CHANDRA PAUL,Independent,1650,7,1657,0.14,S037
13,MD. NAZRUL ISLAM LASKAR,Independent,1382,0,1382,0.12,S037
14,SAHEL AHMED,Independent,1110,1,1111,0.1,S037
15,ABDUL GOFFAR TALUKDAR,Independent,1094,1,1095,0.1,S037
16,SAFIKUR RAHMAN HAZARI,Independent,1031,0,1031,0.09,S037
17,PRAJJWAL SUDIP DEB,Socialist Unity Centre Of India (COMMUNIST),994,7,1001,0.09,S037
18,ABDUL KALAM MAZUMDER,Independent,975,0,975,0.09,S037
19,ALIM UDDIN MAZUMDER,Independent,881,1,882,0.08,S037
20,ABDUL HAMEED,Independent,841,1,842,0.07,S037
21,DEBASHISH GHOSH,Bangali Nabanirman Sena,800,17,817,0.07,S037
22,RASHID AHMED CHOUDHURY,Independent,719,2,721,0.06,S037
23,ABDUS  SUBHAN TAPADAR,Independent,568,3,571,0.05,S037
24,ROKIBUL HUSSAIN CHOUDHURY,Independent,539,6,545,0.05,S037
25,NOTA,None of the Above,2851,89,2940,0.26,S037
1,MUHAMMED HAMDULLAH SAYEED,Indian National Congress,25405,321,25726,52.29,U061
2,MOHAMMED FAIZAL PP,Nationalist Congress Party – Sharadchandra Pawar,22837,242,23079,46.91,U061
3,YOUSUF TP,Nationalist Congress Party,198,3,201,0.41,U061
4,KOYA,Independent,58,3,61,0.12,U061
5,NOTA,None of the Above,132,1,133,0.27,U061
1,AASHTIKAR PATIL NAGESH BAPURAO,Shiv Sena (Uddhav Balasaheb Thackrey),490432,2103,492535,42.49,S1315
2,BABURAO KADAM KOHALIKAR,Shiv Sena,382599,1334,383933,33.12,S1315
3,DR. B. D. CHAVHAN,Vanchit Bahujan  Aaghadi,161324,490,161814,13.96,S1315
4,AMBADAS SUKAJI GADE,Independent,14729,13,14742,1.27,S1315
5,VIJAY RAMJI GABHANE,Communist Party of India  (Marxist),14617,27,14644,1.26,S1315
6,ANAND RAJARAM DHULE,Independent,9807,10,9817,0.85,S1315
7,GAJANAN DHONDBA DAL,Bahujan Samaj Party,7410,55,7465,0.64,S1315
8,DATTA SHRIKRISHNA SURYAWANSHI,Independent,7233,6,7239,0.62,S1315
9,SARJERAO NIVRUTTI KHANDARE,Independent,5010,4,5014,0.43,S1315
10,RAMPRASAD NARAYAN BANGAR,Independent,4518,7,4525,0.39,S1315
11,BABURAO ANANDRAO KADAM,Independent,4469,13,4482,0.39,S1315
12,DEVSARKAR VARSHA SHIVAJIRAO,Bahujan Mukti Party,4081,18,4099,0.35,S1315
13,A. KADIR MASTAN SAYYED (GOREGAONKAR),Independent,3707,6,3713,0.32,S1315
14,ANIL DEVRAO MOHITE,Akhil Bhartiya Parivar Party,3353,21,3374,0.29,S1315
15,SUNIL MOTIRAM GAJBHAR,Independent,3192,0,3192,0.28,S1315
16,ADV ALTAF AHMED,Indian National League,2934,16,2950,0.25,S1315
17,ASHOK PANDURANG RATHOD,Independent,2897,9,2906,0.25,S1315
18,ADV RAVI SHINDE,Independent,2687,14,2701,0.23,S1315
19,SATTAR PATHAN,Independent,2461,2,2463,0.21,S1315
20,MAHESH KAILAS NAPTE,Independent,2298,1,2299,0.2,S1315
21,ADV. SHIVAJIRAO JADHAV,Independent,2181,33,2214,0.19,S1315
22,BHAWAR GOVINDRAO FULAJI,Independent,2138,8,2146,0.19,S1315
23,TRISHALA MILIND KAMBLE,Bahujan Samaj Party  (Ambedkar),2128,22,2150,0.19,S1315
24,PRAKASH MASARAM RANVIR,Republican Party of India (A),2097,5,2102,0.18,S1315
25,ADV. RAMRAO ATMARAM JUMBADE,Independent,2095,9,2104,0.18,S1315
26,DESHA SHYAM BANJARA,Samnak Janta Party,2052,11,2063,0.18,S1315
27,VISHVANATH BHAURAO FALEGAONKAR,Independent,1856,3,1859,0.16,S1315
28,HEMANT RADHAKISHAN KANAKE,Rashtriya Kisan Bahujan Party,1791,9,1800,0.16,S1315
29,RAVI RAMDAS JADHAV (SAWANEKAR),Abhinav Bharat Janseva Paksh,1590,12,1602,0.14,S1315
30,DEWJI GANGARAM ASOLE,Independent,1476,7,1483,0.13,S1315
31,VIJAY DNYANBA RAUT,Independent,1115,11,1126,0.1,S1315
32,SUNIL DASHARATH INGOLE,Bhim Sena,1024,4,1028,0.09,S1315
33,VASANT KISAN PAIKRAO,Independent,590,3,593,0.05,S1315
34,NOTA,None of the Above,3079,44,3123,0.27,S1315
1,BIJULI KALITA  MEDHI,Bharatiya Janata Party,891901,2986,894887,55.95,S035
2,MIRA BORTHAKUR GOSWAMI,Indian National Congress,642353,1444,643797,40.25,S035
3,DIPAK KR BORO,Voters Party  International,8494,54,8548,0.53,S035
4,COLONEL GOKUL CHANDRA SINGHA,Independent,7644,34,7678,0.48,S035
5,AMITABH SARMA,Ekam Sanatan Bharat Dal,7508,19,7527,0.47,S035
6,KAZI NEKIB  AHMED,Independent,6753,8,6761,0.42,S035
7,SAMAD CHOUDHURY,Bharatiya Gana Parishad,5081,14,5095,0.32,S035
8,SHEJON GOYARY,Bahujan Maha Party,4826,21,4847,0.3,S035
9,NOTA,None of the Above,20139,110,20249,1.27,S035
1,MIAN ALTAF AHMAD,Jammu & Kashmir National Conference,517489,4347,521836,50.85,U083
2,MEHBOOBA MUFTI,Jammu & Kashmir Peoples Democratic Party,238210,1832,240042,23.39,U083
3,ZAFAR IQBAL KHAN MANHAS,Jammu and Kashmir Apni Party,141316,879,142195,13.86,U083
4,MOHAMAD SALEEM PARAY,Democratic Progressive Azad Party,25440,121,25561,2.49,U083
5,ABDUL RAOUF MALIK,Independent,10566,16,10582,1.03,U083
6,SUSHIL KUMAR SHARMA,Independent,9102,126,9228,0.9,U083
7,ABDUL ROUF NAIK,Independent,9079,70,9149,0.89,U083
8,SAJAD AHMAD DAR,Independent,7988,16,8004,0.78,U083
9,IMRAN SHEIKH,Independent,7457,28,7485,0.73,U083
10,IMTIYAZ AHMAD,National Loktantrik Party,6936,77,7013,0.68,U083
11,ARSHEED AHMED LONE,Jammu & Kashmir National Panthers Party (Bhim),6163,226,6389,0.62,U083
12,BALDEV KUMAR,Independent,6120,69,6189,0.6,U083
13,ALI MOHAMMAD WANI,Independent,5238,17,5255,0.51,U083
14,SHEIKH MUZAFAR AHMED,Jammu and Kashmir Nationalist People's Front,4774,40,4814,0.47,U083
15,DILIP KUMAR PANDITA,Independent,3638,84,3722,0.36,U083
16,RAVINDER SINGH,Independent,2828,134,2962,0.29,U083
17,GULSHAN AKHTER,Independent,2778,29,2807,0.27,U083
18,MOHAMMAD MAQBOOL TELI,Garib Democratic Party,2731,17,2748,0.27,U083
19,SUDARSHAN SINGH,National Awami United Party,2166,216,2382,0.23,U083
20,JAVAID AHMED,All India Forward Bloc,1534,28,1562,0.15,U083
21,NOTA,None of the Above,5967,256,6223,0.61,U083
1,S JAGATHRATCHAKAN,Dravida Munnetra Kazhagam,560578,2638,563216,48.39,S227
2,L VIJAYAN,All India Anna Dravida Munnetra Kazhagam,255343,1314,256657,22.05,S227
3,K BALU,Pattali Makkal Katchi,200614,1711,202325,17.38,S227
4,S AFSHIA NASRIN,Naam Tamilar Katchi,97985,959,98944,8.5,S227
5,D PANDIYAN,Bahujan Samaj Party,6135,77,6212,0.53,S227
6,A PALANI,Independent,3855,11,3866,0.33,S227
7,K MANIGANDAN,Independent,2045,4,2049,0.18,S227
8,INDU W,Tamil Manila Murpokku Dravida Kazhagam,1872,66,1938,0.17,S227
9,DR A V NARENDRAN,Independent,1711,11,1722,0.15,S227
10,M VIJAYAN,Independent,1674,4,1678,0.14,S227
11,M BALU,Independent,1557,4,1561,0.13,S227
12,SHETTU S,Independent,1556,5,1561,0.13,S227
13,V BABU,United Republican Party of India,1351,15,1366,0.12,S227
14,M THULASIRAMAN,Independent,1046,7,1053,0.09,S227
15,D JANAKIRAMAN,Independent,831,6,837,0.07,S227
16,S SURESH KUMAR,Independent,828,7,835,0.07,S227
17,R VINOTH,Veerath Thiyagi Viswanathadoss Thozhilalarkal Katchi,819,2,821,0.07,S227
18,V VINAYAGAM,Independent,727,2,729,0.06,S227
19,VIJAYAN K,All India Jananayaka Makkal Kazhagam,624,9,633,0.05,S227
20,SHANAVAS J,Independent,580,3,583,0.05,S227
21,V KRISHNANANDAN,Anna MGR Dravida Makkal Kalgam,568,14,582,0.05,S227
22,A JAYACHANDRAN,Independent,534,4,538,0.05,S227
23,N SUGUMAR,Independent,424,8,432,0.04,S227
24,M VIJAY,Independent,416,11,427,0.04,S227
25,G SUDHAKAR,Independent,367,13,380,0.03,S227
26,K VENKATESAN,Independent,261,3,264,0.02,S227
27,NOTA,None of the Above,12423,190,12613,1.08,S227
1,BASTIPATI NAGARAJU PANCHALINGALA,Telugu Desam,650335,8579,658914,49.51,S0118
2,B Y RAMAIAH,Yuvajana Sramika Rythu Congress Party,543801,3815,547616,41.15,S0118
3,P.G.RAMPULLAIAH YADAV LUCKY-2,Indian National Congress,68972,1401,70373,5.29,S0118
4,MANCHALA LAKSHMI NARAYANA,Bahujan Samaj Party,8533,56,8589,0.65,S0118
5,BOYA SURESH,Independent,5891,9,5900,0.44,S0118
6,T. BEECHUPALLI,Independent,5125,2,5127,0.39,S0118
7,VIJAYA BHASKAR .REDDYPOGU,Independent,3504,4,3508,0.26,S0118
8,PAGADALA KODANDA,Independent,3070,6,3076,0.23,S0118
9,DEVARAPOGU MADDILETY,Independent,2576,6,2582,0.19,S0118
10,PRAKASH REDDY RALAMPADU,Independent,2222,3,2225,0.17,S0118
11,JAHANGIR AHMED,Social Democratic Party Of India,2058,16,2074,0.16,S0118
12,DR. REDDYPOGU PRAVEEN KUMAR,Independent,1847,9,1856,0.14,S0118
13,ABDUL SATTAR  A.S.R,Anna YSR Congress Party,1565,36,1601,0.12,S0118
14,VALMIKI ARJUNA,Bharatha Chaitanya Yuvajana Party,1385,5,1390,0.1,S0118
15,URUKUNDU VADDE,Independent,1284,11,1295,0.1,S0118
16,MALLEPOGU NAGANNA,Socialist Unity Centre Of India (COMMUNIST),1162,2,1164,0.09,S0118
17,SUNKARA SREEDHAR,Jai Bharat National Party,1149,14,1163,0.09,S0118
18,TARIGOPULA RAJABABU,All Peoples Party,1032,1,1033,0.08,S0118
19,AMRUTH KUMAR SALKAPURAM,Liberation Congress Party,777,6,783,0.06,S0118
20,NOTA,None of the Above,10394,117,10511,0.79,S0118
1,JOTHIMANI. S,Indian National Congress,531829,3077,534906,47.25,S2223
2,THANGAVEL. L,All India Anna Dravida Munnetra Kazhagam,366209,1881,368090,32.52,S2223
3,SENTHILNATHAN. V.V,Bharatiya Janata Party,101517,965,102482,9.05,S2223
4,KARUPPAIYA. R,Naam Tamilar Katchi,86962,541,87503,7.73,S2223
5,SANKARAN. S,Bahujan Samaj Party,2665,15,2680,0.24,S2223
6,SAKTHIVEL. R,Independent,2391,22,2413,0.21,S2223
7,ABILAZAN. N,Independent,1916,5,1921,0.17,S2223
8,KARTHIKPERUMAL. R,Independent,1808,1,1809,0.16,S2223
9,KATHIRAVAN. P,Independent,1445,3,1448,0.13,S2223
10,KARUNAMOORTHY. S,Independent,1278,0,1278,0.11,S2223
11,MOHAMED NAZEEM. S,Independent,938,0,938,0.08,S2223
12,PALANISAMY. N.A,Independent,934,0,934,0.08,S2223
13,SHANMUGAM. N,Samaniya Makkal Nala Katchi,924,5,929,0.08,S2223
14,KALAIRAJ. K,Independent,809,2,811,0.07,S2223
15,JOTHIMANI. A.K,Independent,805,3,808,0.07,S2223
16,KANNAN. T,Independent,782,6,788,0.07,S2223
17,JOTHIMANI. S,Independent,774,6,780,0.07,S2223
18,SATHASIVAM. R,Independent,728,1,729,0.06,S2223
19,MANIKANDAN. K,Independent,685,0,685,0.06,S2223
20,KOSAMALAR. P,Independent,641,3,644,0.06,S2223
21,MURUGESAN. K,Ganasangam Party of India,628,2,630,0.06,S2223
22,MAHESWARAN. A,Independent,589,1,590,0.05,S2223
23,REGIS THIYAGARAJAN. V.G.A,Independent,570,2,572,0.05,S2223
24,VINCENT. F,Anti Corruption Dynamic Party,510,5,515,0.05,S2223
25,NATRAYAN. R,Independent,503,0,503,0.04,S2223
26,BANUMATHY. S,Independent,494,2,496,0.04,S2223
27,UMADEVI. S,Independent,452,1,453,0.04,S2223
28,VARADAN. M,Independent,428,1,429,0.04,S2223
29,MURALI. M,Independent,417,0,417,0.04,S2223
30,SAKTHIVEL. N,Independent,414,1,415,0.04,S2223
31,BABU. G,Independent,387,0,387,0.03,S2223
32,JAFAR ALI. A,Independent,368,3,371,0.03,S2223
33,PRABHU. G,Independent,354,0,354,0.03,S2223
34,PALANIVEL. P,Independent,350,0,350,0.03,S2223
35,ANBAZHAGAN. T,Independent,338,1,339,0.03,S2223
36,MURUGESAN. P,Independent,327,0,327,0.03,S2223
37,SOWMIYA. R,Independent,307,3,310,0.03,S2223
38,SATHISHKUMAR. S,Independent,304,2,306,0.03,S2223
39,DHURAIYARASAN. P,Independent,273,2,275,0.02,S2223
40,VINOTH KUMAR. N,Independent,273,3,276,0.02,S2223
41,SATHIS KUMAR. C,Independent,258,9,267,0.02,S2223
42,THIRUGNANAM. M,Independent,253,5,258,0.02,S2223
43,SATHISH. P,Independent,241,3,244,0.02,S2223
44,MAHAMUNI. A,Independent,213,0,213,0.02,S2223
45,RAJAPANDIAN. K,Independent,207,2,209,0.02,S2223
46,JOTHIVEL. A,Independent,206,0,206,0.02,S2223
47,BASKARAN. N,Independent,205,0,205,0.02,S2223
48,PUSHPARAJ. N,Independent,199,0,199,0.02,S2223
49,NARENDRAKUMAR. G,Independent,197,0,197,0.02,S2223
50,PRASANTH. S,Independent,194,0,194,0.02,S2223
51,SUBASH MALAYALAM. T,Independent,186,0,186,0.02,S2223
52,NAGESVARAN. P,Independent,185,0,185,0.02,S2223
53,DANIYA. P,Independent,165,0,165,0.01,S2223
54,SIVAKUMAR. V,Independent,150,1,151,0.01,S2223
55,NOTA,None of the Above,8174,101,8275,0.73,S2223
1,ANURAG SHARMA,Bharatiya Janata Party,689438,878,690316,50,S2446
2,"PRADEEP JAIN ""ADITYA""",Indian National Congress,587000,702,587702,42.57,S2446
3,RAVI PRAKASH,Bahujan Samaj Party,63106,86,63192,4.58,S2446
4,LAKHAN LAL,Independent,6832,0,6832,0.49,S2446
5,RAMESH,Independent,6330,8,6338,0.46,S2446
6,GANESH RAM,Independent,2574,1,2575,0.19,S2446
7,CHANDAN SINGH,Apna Dal (Kamerawadi),2487,4,2491,0.18,S2446
8,DHARMENDRA PRATAP,Independent,2299,4,2303,0.17,S2446
9,INDRA SINGH,Independent,2076,2,2078,0.15,S2446
10,ER. DEEPAK KUMAR VERMA,Al-Hind Party,1375,2,1377,0.1,S2446
11,NOTA,None of the Above,15290,12,15302,1.11,S2446
1,HARISH CHANDRA MEENA,Indian National Congress,617137,6626,623763,50.85,S2012
2,SUKHBIR SINGH JAUNAPURIA,Bharatiya Janata Party,553309,5505,558814,45.56,S2012
3,PRAHALAD MALI,Bahujan Samaj Party,13089,55,13144,1.07,S2012
4,GANESH MEENA,Indian Peoples Green Party,7425,8,7433,0.61,S2012
5,MAKHAN LAL MEENA,Independent,3314,10,3324,0.27,S2012
6,JASRAM MEENA,Independent,3044,1,3045,0.25,S2012
7,VIJENDRA,Aazad Samaj Party (Kanshi Ram),2669,28,2697,0.22,S2012
8,GIRRAJ PRASAD MEENA,Independent,2512,9,2521,0.21,S2012
9,JAGDISH PRASAD MEENA,Bharat Adivasi Party,1366,7,1373,0.11,S2012
10,DULI CHAND SAINI,Rajasthan Raj Party,1253,11,1264,0.1,S2012
11,JAGDISH PRASAD SHARMA,Bheem Tribal Congress,1023,6,1029,0.08,S2012
12,NOTA,None of the Above,8105,72,8177,0.67,S2012
1,AWADHESH PRASAD,Samajwadi Party,553549,740,554289,48.59,S2454
2,LALLU SINGH,Bharatiya Janata Party,499002,720,499722,43.81,S2454
3,SACHIDANAND PANDEY,Bahujan Samaj Party,46347,60,46407,4.07,S2454
4,ARVIND SEN,Communist Party of India,15353,14,15367,1.35,S2454
5,SUNIL KUMAR BHATT,Independent,3826,1,3827,0.34,S2454
6,KANCHAN YADAV,Moulik Adhikar Party,2662,4,2666,0.23,S2454
7,AMBRISH DEV GUPTA,Bharat Mahaparivar Party,2216,2,2218,0.19,S2454
8,FAREED SALMANI,Independent,1779,1,1780,0.16,S2454
9,LAL MANI URF L.M. TRIPATHI (BHAI SAHAB),Independent,1717,0,1717,0.15,S2454
10,ANIL KUMAR RAVAT,Rashtriya Janshakti Samaj Party,1636,2,1638,0.14,S2454
11,JAGAT SINGH,Independent,1252,2,1254,0.11,S2454
12,BRAJENDRA DUTT TRIPATHI URF B. D. TRIPATHI,Adarshwaadi Congress Party,1163,10,1173,0.1,S2454
13,ARUN KUMAR,Independent,1063,4,1067,0.09,S2454
14,NOTA,None of the Above,7529,7,7536,0.66,S2454
1,VIJAYLAKSHMI DEVI,Janata Dal  (United),385625,883,386508,38.73,S0418
2,HENA SHAHAB,Independent,293084,567,293651,29.42,S0418
3,AWADH BIHARI CHOUDHARY,Rashtriya Janata Dal,198063,760,198823,19.92,S0418
4,SATYENDRA KUSHWAHA,Independent,21558,7,21565,2.16,S0418
5,JEEWAN KUMAR,Independent,18489,101,18590,1.86,S0418
6,DILIP KU SINGH,Bahujan Samaj Party,12032,80,12112,1.21,S0418
7,SANJAY KUMAR SAH,Bhartiya Lok Nayak Party,8851,28,8879,0.89,S0418
8,DR. RAVINDRA NATH SHUKLA,Independent,8681,12,8693,0.87,S0418
9,DEVKANT MISHRA,Independent,6162,19,6181,0.62,S0418
10,PRAMOD KUMAR,Independent,5666,2,5668,0.57,S0418
11,PRAKASH MANI TIWARI,Independent,4503,6,4509,0.45,S0418
12,MAHENDRA SINGH ALIAS MAHENDRA RAI,Independent,3920,2,3922,0.39,S0418
13,DILIP KUMAR SINGH,Independent,1947,6,1953,0.2,S0418
14,NOTA,None of the Above,26925,39,26964,2.7,S0418
1,MALAIYARASAN D,Dravida Munnetra Kazhagam,558346,3243,561589,44.94,S2214
2,KUMARAGURU R,All India Anna Dravida Munnetra Kazhagam,505577,2228,507805,40.64,S2214
3,JAGADESAN A,Naam Tamilar Katchi,73098,554,73652,5.89,S2214
4,DEVADASS RAMASAMY,Pattali Makkal Katchi,70633,657,71290,5.71,S2214
5,PRABU C,Independent,4268,7,4275,0.34,S2214
6,BALAKRISHNAN P,Independent,3468,1,3469,0.28,S2214
7,JEEVANRAJ N,Bahujan Samaj Party,3075,21,3096,0.25,S2214
8,MAYILAMPARAI MARI A,Independent,2891,1,2892,0.23,S2214
9,NATTANMAI GUNASEKARANA A.S,Anna Makkal Katchi,2497,8,2505,0.2,S2214
10,KUMARAGURU N,Independent,2226,1,2227,0.18,S2214
11,MURUGESAN M,Independent,2223,2,2225,0.18,S2214
12,SUBRAMANIAN R K,Independent,868,4,872,0.07,S2214
13,ARUL INIYAN A,Independent,772,12,784,0.06,S2214
14,VENKATRAMAN J,Naadaalum Makkal Katchi,687,4,691,0.06,S2214
15,KAMALAKANNAN M,Independent,629,1,630,0.05,S2214
16,GOVINDARAJ S R,Independent,533,25,558,0.04,S2214
17,PALANIYAMMAL S,Desiya Makkal Sakthi Katchi,533,15,548,0.04,S2214
18,SIGAMANI A,Independent,515,27,542,0.04,S2214
19,RAJASEKAR K,Independent,501,10,511,0.04,S2214
20,JAYABAL PM,Independent,473,3,476,0.04,S2214
21,RAJAMANICKAM C,Independent,398,1,399,0.03,S2214
22,NOTA,None of the Above,8351,181,8532,0.68,S2214
1,THANGA TAMILSELVAN,Dravida Munnetra Kazhagam,569110,2383,571493,50.08,S2233
2,TTV DHINAKARAN,Amma Makkal Munnettra Kazagam,289909,2759,292668,25.65,S2233
3,NARAYANASAMY V T,All India Anna Dravida Munnetra Kazhagam,154871,716,155587,13.63,S2233
4,MADHAN,Naam Tamilar Katchi,75495,1339,76834,6.73,S2233
5,PRAKASH P,Independent,6293,5,6298,0.55,S2233
6,PANDIKUMAR S,Independent,3907,60,3967,0.35,S2233
7,AJEETHKUMAR S,Independent,2977,29,3006,0.26,S2233
8,PARAMASIVAN S,Independent,2852,14,2866,0.25,S2233
9,PARTHIBAN G,Independent,2275,2,2277,0.2,S2233
10,JEEVA M,Bahujan Samaj Party,2123,99,2222,0.19,S2233
11,CHARCHIL DURAI P,Humanity for Peace Party,1905,30,1935,0.17,S2233
12,PREMA S,Independent,1225,7,1232,0.11,S2233
13,MANIKANDAN R,Independent,1195,6,1201,0.11,S2233
14,REVATHI K,Independent,1115,13,1128,0.1,S2233
15,MUDIYARASU,All India Youth Development Party,1078,16,1094,0.1,S2233
16,THIAGARAJAN O V,Independent,924,8,932,0.08,S2233
17,VASANTHA SARAVANAN,Independent,803,2,805,0.07,S2233
18,VIJAYAN K,Independent,665,2,667,0.06,S2233
19,SETHUPATHI G,Independent,613,4,617,0.05,S2233
20,JOHNGILBERTRAJ,Independent,598,5,603,0.05,S2233
21,AATHIMUTHUKUMAR M,Independent,587,5,592,0.05,S2233
22,MUTHUKUMAR,Independent,539,4,543,0.05,S2233
23,HARIKRISHNAKUMAR R,Independent,481,5,486,0.04,S2233
24,SATHEESH KUMAR A,Independent,447,6,453,0.04,S2233
25,KUMAR,Independent,376,1,377,0.03,S2233
26,NOTA,None of the Above,11206,130,11336,0.99,S2233
1,ATUL GARG,Bharatiya Janata Party,853036,1134,854170,58.09,S2412
2,DOLLY SHARMA,Indian National Congress,516699,506,517205,35.17,S2412
3,NAND KISHOR PUNDIR,Bahujan Samaj Party,79387,138,79525,5.41,S2412
4,RAVI KUMAR PANCHAL,Independent,1965,1,1966,0.13,S2412
5,ANAND KUMAR,Rashtra Nirman Party,1174,4,1178,0.08,S2412
6,NATTHUSINGH CHAUDHARY,Independent,1159,3,1162,0.08,S2412
7,AURANGJEB,Independent,1120,0,1120,0.08,S2412
8,NAMAHA,Samaj Vikas Kranti Party,1079,1,1080,0.07,S2412
9,AVDESH KUMAR,Independent,1037,6,1043,0.07,S2412
10,POOJA SAXENA,Right to Recall Party,874,4,878,0.06,S2412
11,KAVITA,Independent,772,3,775,0.05,S2412
12,ANSUL GUPTA,Rashtriya Jan Karmath Party,763,1,764,0.05,S2412
13,DHIRENDRA SINGH BHADAURIYA,Subhashwadi Bhartiya Samajwadi Party (Subhas Party),696,4,700,0.05,S2412
14,ABHISHEK PUNDIR,Independent,652,1,653,0.04,S2412
15,NOTA,None of the Above,8195,16,8211,0.56,S2412
1,RAMBHUAL NISHAD,Samajwadi Party,442886,1444,444330,43,S2438
2,MANEKA SANJAY GANDHI,Bharatiya Janata Party,399859,1297,401156,38.82,S2438
3,UDRAJ VERMA,Bahujan Samaj Party,162603,422,163025,15.78,S2438
4,ABDUL MABOOD,Apna Desh Party,4295,2,4297,0.42,S2438
5,MOHAMMAD ASIF,Independent,3382,5,3387,0.33,S2438
6,UDAYRAJ VERMA,Independent,2900,9,2909,0.28,S2438
7,GIRISH LAL,Azad Party,2305,6,2311,0.22,S2438
8,DR SHIV SHANKAR INDIAN,Most Backward Classes Of India,2085,5,2090,0.2,S2438
9,JAY PRAKASH,Sardar Patel Siddhant Party,1364,5,1369,0.13,S2438
10,NOTA,None of the Above,8500,13,8513,0.82,S2438
1,RAO INDERJIT SINGH,Bharatiya Janata Party,805161,3175,808336,50.48,S079
2,RAJ BABBAR,Indian National Congress,731696,1561,733257,45.79,S079
3,RAHUL YADAV FAZILPURIA,Jannayak Janta Party,13214,64,13278,0.83,S079
4,VIJAY KHATANA,Bahujan Samaj Party,8900,46,8946,0.56,S079
5,SORAB KHAN,Indian National Lok Dal,4897,20,4917,0.31,S079
6,AJAY KUMAR,Independent,3527,1,3528,0.22,S079
7,ASHOK JANGRA,Independent,3002,3,3005,0.19,S079
8,AZAD SINGH,Independent,2744,1,2745,0.17,S079
9,AKSHAT GAIT,Independent,2549,1,2550,0.16,S079
10,LAL CHAND YADAV,Bharatheeya Jawan Kisan Party,2214,8,2222,0.14,S079
11,SAMAY SINGH,Independent,1885,2,1887,0.12,S079
12,DHARMENDER THAKRAN,Swayam Shashan Party,1402,6,1408,0.09,S079
13,VIJAY YADAV,Jan Sewak Kranti Party,1120,0,1120,0.07,S079
14,ISHWAR SINGH SUTHANI,Peoples Party of India (Democratic),1110,4,1114,0.07,S079
15,COMRADE SARWAN KUMAR GUPTA,Socialist Unity Centre Of India (COMMUNIST),1066,8,1074,0.07,S079
16,VANDNA GULIYA,Right to Recall Party,980,20,1000,0.06,S079
17,SAMPOORN ANAND,Rashtriya Lokswaraj Party,911,4,915,0.06,S079
18,KUSHESHWAR  BHAGAT,Independent,794,0,794,0.05,S079
19,SINGH RAM,Independent,789,2,791,0.05,S079
20,ANWAR,Social Democratic Party Of India,572,6,578,0.04,S079
21,FAUJI JAI KAWAR TYAGI (DIXIT),Independent,469,5,474,0.03,S079
22,AKASH VYAS,Bhartiya Shakti Chetna Party,436,3,439,0.03,S079
23,VISHNU,Independent,436,1,437,0.03,S079
24,NOTA,None of the Above,6377,40,6417,0.4,S079
1,SHRIRANG APPA CHANDU BARNE,Shiv Sena,692101,731,692832,48.81,S1333
2,SANJOG BHIKU WAGHERE PATIL,Shiv Sena (Uddhav Balasaheb Thackrey),595542,675,596217,42,S1333
3,MADHAVITAI  NARESH JOSHI,Vanchit Bahujan  Aaghadi,27745,23,27768,1.96,S1333
4,RAJARAM NARAYAN PATIL,Bahujan Samaj Party,13982,21,14003,0.99,S1333
5,ADV JYOTISHWAR VISHNU BHOSALE,Baliraja Party,10874,5,10879,0.77,S1333
6,UMAKANT RAMESHWAR MISHRA,Independent,5029,1,5030,0.35,S1333
7,SANJOG  PATIL,Independent,4828,2,4830,0.34,S1333
8,KAMBLE MARUTI APARAI,Independent,4827,2,4829,0.34,S1333
9,AJAY HANUMANT LONDHE,Independent,4766,1,4767,0.34,S1333
10,SANTOSH UBALE,Bhim Sena,3824,1,3825,0.27,S1333
11,ADHALGE LAXMAN SADASHIV,Independent,3166,1,3167,0.22,S1333
12,SUHAS MANOHAR RANE,Independent,2923,0,2923,0.21,S1333
13,IQBAL IBRAHIM NAWDEKAR,Independent,2899,1,2900,0.2,S1333
14,DADARAO KISAN KAMBLE,Independent,2636,6,2642,0.19,S1333
15,RAHUL NIVRUTTI MADANE,Independent,2279,3,2282,0.16,S1333
16,TUSHAR DIGAMBAR LONDHE,Bahujan Bharat Party,2199,4,2203,0.16,S1333
17,RAHIM MAINUDDIN SAYYAD,Aazad Samaj Party (Kanshi Ram),2148,1,2149,0.15,S1333
18,INDRAJEET D GOND,Independent,2135,0,2135,0.15,S1333
19,SHIVAJI KISAN JADHAV,All India Forward Bloc,1672,4,1676,0.12,S1333
20,YASHWANT VITTHAL PAWAR,Kranti Kari Jai Hind Sena,1634,4,1638,0.12,S1333
21,PRAFUL PANDIT BHOSALE,Independent,1602,1,1603,0.11,S1333
22,RAJENDRA MARUTI KATE,Independent,1417,2,1419,0.1,S1333
23,MAHESH THAKUR,Dharmarajya Paksha,1369,3,1372,0.1,S1333
24,PRASHANT RAMKRISHNA BHAGAT,Bharatheeya Jawan Kisan Party,1283,8,1291,0.09,S1333
25,PANKAJ PRABHAKAR OZARKAR,Akhil Bhartiya Parivar Party,1259,2,1261,0.09,S1333
26,MANOJ BHASKAR GARBADE,Independent,1233,0,1233,0.09,S1333
27,HAJRAT IMAMSAB PATEL,Independent,1093,0,1093,0.08,S1333
28,GOVIND GANGARAM HERODE,Independent,966,0,966,0.07,S1333
29,MADHUKAR DAMODAR THORAT,Independent,905,0,905,0.06,S1333
30,RAFIQUE RASHID QURESHI,Desh Janhit Party,829,0,829,0.06,S1333
31,CHIMAJI DHONDIBA SHINDE,Independent,757,0,757,0.05,S1333
32,ADV RAJU PATIL,Independent,669,1,670,0.05,S1333
33,MUKESH MANOHAR AGARWAL,Independent,546,1,547,0.04,S1333
34,NOTA,None of the Above,16729,31,16760,1.18,S1333
1,RAO RAJENDRA SINGH,Bharatiya Janata Party,608189,9688,617877,48.96,S206
2,ANIL CHOPRA,Indian National Congress,602293,13969,616262,48.83,S206
3,HANUMAN SAHAY,Bahujan Samaj Party,3773,77,3850,0.31,S206
4,RAMSINGH KASANA,Independent,3701,6,3707,0.29,S206
5,DR DASHRATH HINUNIA,Ambedkarite Party of India,2669,12,2681,0.21,S206
6,KAHANVI BOHRA,Independent,1658,53,1711,0.14,S206
7,DR RAM ROOP MEENA ADVOCATE,Independent,1589,15,1604,0.13,S206
8,NEHA SINGH GURJAR,Independent,1378,29,1407,0.11,S206
9,PRAKASH KUMAR SHARMA,Independent,1033,7,1040,0.08,S206
10,AJAY BHAT,Republican Party of India (A),931,17,948,0.08,S206
11,DEVHANS,Independent,924,17,941,0.07,S206
12,DR OM SINGH MEENA SEHARA,Independent,676,58,734,0.06,S206
13,ADITYA PRAKASH SHARMA,Right to Recall Party,650,16,666,0.05,S206
14,YOGI JEETENDRA NATH ADVOCATE,Rashtriya Sawarn Dal,556,6,562,0.04,S206
15,ADVOCATE HARI KISHAN TIWARI,Bheem Tribal Congress,541,4,545,0.04,S206
16,NOTA,None of the Above,7405,114,7519,0.6,S206
1,MALVINDER SINGH KANG,Aam Aadmi Party,312241,976,313217,29.08,S196
2,VIJAY INDER SINGLA,Indian National Congress,301414,957,302371,28.07,S196
3,DR SUBHASH SHARMA,Bharatiya Janata Party,185836,742,186578,17.32,S196
4,PREM SINGH CHANDUMAJRA,Shiromani Akali Dal,117651,285,117936,10.95,S196
5,JASVIR SINGH GARHI,Bahujan Samaj Party,89953,204,90157,8.37,S196
6,KUSHAL PAL SINGH MANN,Shiromani Akali Dal (Amritsar)(Simranjit Singh Mann),24725,106,24831,2.31,S196
7,GAJJAN SINGH,Independent,6164,7,6171,0.57,S196
8,SIMPLE KUMAR,Independent,2962,0,2962,0.27,S196
9,SATPAL,Independent,2294,3,2297,0.21,S196
10,GURMIT SINGH,Independent,2179,3,2182,0.2,S196
11,DHARMINDER SINGH HARMAN,Akhil Bhartiya Parivar Party,2037,6,2043,0.19,S196
12,SUNIL KUMAR,Bhartiya Jan Samman Party,1968,9,1977,0.18,S196
13,ER DALJEET SINGH SAINI,Bharatheeya Jawan Kisan Party,1710,5,1715,0.16,S196
14,KULWINDER SINGH,Democratic Bharatiya Samaj Party,1651,1,1652,0.15,S196
15,SUNAINA,Bhartiya Rashtriya Dal,1621,19,1640,0.15,S196
16,ADV KULWINDER SINGH,Independent,1596,4,1600,0.15,S196
17,MEGH RAJ,Independent,1429,1,1430,0.13,S196
18,HARWINDER KARWAL,Independent,1309,2,1311,0.12,S196
19,DAVINDER SINGH,Independent,1164,11,1175,0.11,S196
20,DARSHAN SINGH,Punjab National Party,1164,8,1172,0.11,S196
21,HANISH SHARMA,Ekam Sanatan Bharat Dal,1072,4,1076,0.1,S196
22,DEEPAK SHARMA,Independent,1012,0,1012,0.09,S196
23,PARMINDER SINGH,Independent,930,0,930,0.09,S196
24,YOG RAJ SAHOTA,Revolutionary Socialist Party,925,0,925,0.09,S196
25,RAMJAAN KHAN,Independent,672,0,672,0.06,S196
26,ROHTASH,Independent,617,2,619,0.06,S196
27,MANDAR SINGH,Independent,555,0,555,0.05,S196
28,KIRAN JAIN,Hindustan Shakti Sena,507,8,515,0.05,S196
29,NOTA,None of the Above,6351,51,6402,0.59,S196
1,DR.K.SUDHAKAR,Bharatiya Janata Party,819588,3031,822619,53.74,S1027
2,M.S. RAKSHA RAMAIAH,Indian National Congress,657489,1670,659159,43.06,S1027
3,MUNIVENKATAPPA M.P,Communist Party of India  (Marxist),4546,11,4557,0.3,S1027
4,MAHADEV. P,Bahujan Samaj Party,4428,12,4440,0.29,S1027
5,RAJANNA,Independent,3759,5,3764,0.25,S1027
6,RAJA REDDY,Independent,3377,4,3381,0.22,S1027
7,KALAVATHI. N,Socialist Unity Centre Of India (COMMUNIST),2736,8,2744,0.18,S1027
8,VALASAPALLI UTAPPA,Independent,2152,10,2162,0.14,S1027
9,VENKATESHMURTHY.V,Uttama Prajaakeeya Party,2015,5,2020,0.13,S1027
10,D. SUDHAKARA,Independent,1678,11,1689,0.11,S1027
11,SUDHAKAR. N,Independent,1581,10,1591,0.1,S1027
12,G N RAVI,Independent,1462,3,1465,0.1,S1027
13,BHASKAR ANKALAMADUGU SHIVAREDDY,Independent,1363,4,1367,0.09,S1027
14,CHANDRASHEKAR. H.C,Independent,1270,12,1282,0.08,S1027
15,MOHITH NARASIMHAMURTHY,Independent,1222,7,1229,0.08,S1027
16,V.N. NARASIMHAMURTHY VADIGERE,Independent,1212,6,1218,0.08,S1027
17,G.N. VENKATESH B.A.L.L.B,Independent,1199,8,1207,0.08,S1027
18,DEVARAJ CORONA WARRIOR,Independent,1168,9,1177,0.08,S1027
19,G SUBRAMANI SHETTY,Karnataka Rashtra Samithi,869,3,872,0.06,S1027
20,DR. M.R. RANGANATHA,Independent,850,7,857,0.06,S1027
21,NAGESH. S,Digvijaya Bharatha Party,843,7,850,0.06,S1027
22,T.R. NARAYANA RAO,Indian Labour Party (Ambedkar Phule),757,5,762,0.05,S1027
23,"C.V.  LOKESH GOWDA, B.E",Independent,691,10,701,0.05,S1027
24,D. CHINNAPPA,Independent,616,3,619,0.04,S1027
25,SANDESH.G,Independent,588,6,594,0.04,S1027
26,NASURULLA,Independent,579,4,583,0.04,S1027
27,K. VENKATESH,Independent,469,5,474,0.03,S1027
28,T VENKATA SIVUDU,Independent,434,6,440,0.03,S1027
29,G N. KODANDAREDDY,Independent,399,2,401,0.03,S1027
30,NOTA,None of the Above,6545,51,6596,0.43,S1027
1,KUNDURU RAGHUVEER,Indian National Congress,772264,12073,784337,60.5,S2913
2,SAIDI REDDY SHANAMPUDI,Bharatiya Janata Party,219606,4826,224432,17.31,S2913
3,KANCHARLA KRISHNA REDDY,Bharat Rashtra Samithi,216681,1736,218417,16.85,S2913
4,JANAIAH NANDIPATI,Telangana Sakalajanula Party,10832,27,10859,0.84,S2913
5,NAGARAJU BANDARU,Independent,7122,6,7128,0.55,S2913
6,ANJAIAH VIRIGINENI,Bahujan Samaj Party,7075,102,7177,0.55,S2913
7,MARAM VENKAT REDDY,Independent,5962,5,5967,0.46,S2913
8,PANUGOTU LALASINGH,Independent,5277,9,5286,0.41,S2913
9,THALARI RAMBABU,Dharma Samaj Party,5028,94,5122,0.4,S2913
10,RAMESH SUNKARA,Independent,3566,3,3569,0.28,S2913
11,POLISHETTY VENKATESHWARLU,Independent,3202,10,3212,0.25,S2913
12,KUKKALA VENKANNA,Independent,2561,5,2566,0.2,S2913
13,CHOLLETI PRABHAKAR,Independent,2482,22,2504,0.19,S2913
14,GOLI SAIDULU,Independent,1770,9,1779,0.14,S2913
15,MARRI NEHEMIAH,Independent,1653,9,1662,0.13,S2913
16,RAVI PALAKURI,Independent,1545,2,1547,0.12,S2913
17,VASKULA MATTAIAH,Marxist Communist Party of India (United),1033,7,1040,0.08,S2913
18,KUNDARAPU SRIKANTH,Independent,940,7,947,0.07,S2913
19,RACHA SUBHADRA REDDY,Socialist Party (India),835,11,846,0.07,S2913
20,LINGAM KRISHNA,Independent,666,0,666,0.05,S2913
21,KINNERA YADAIAH,Independent,654,7,661,0.05,S2913
22,SHIRISHALA SRINAIAH,Independent,513,1,514,0.04,S2913
23,NOTA,None of the Above,5869,217,6086,0.47,S2913
1,ZIA UR REHMAN,Samajwadi Party,570745,416,571161,47.8,S248
2,PARMESHWAR LAL SAINI,Bharatiya Janata Party,448983,684,449667,37.63,S248
3,CHAUDHARY SAULAT ALI,Bahujan Samaj Party,152317,143,152460,12.76,S248
4,WASEEM SO MOH SHAMIM,Independent,3863,1,3864,0.32,S248
5,MOHD WASEEM SO MOHD FAREED,Independent,2077,0,2077,0.17,S248
6,JAYGAMUL ISLAM,Janta Shashan Party,1940,2,1942,0.16,S248
7,ANUJ VARSHNEY,Independent,1674,3,1677,0.14,S248
8,MAHANDRA SINGH,Independent,1291,3,1294,0.11,S248
9,SANTOSH,Kisan Kranti Dal,1201,3,1204,0.1,S248
10,DR RASHID,Peace Party,1059,1,1060,0.09,S248
11,TAUFIK AHAMAD,Independent,722,1,723,0.06,S248
12,PAVAN KUMAR,Log Party,636,1,637,0.05,S248
13,NOTA,None of the Above,7213,4,7217,0.6,S248
1,BALRAM NAIK PORIKA,Indian National Congress,608505,4269,612774,55.27,S2916
2,KAVITHA MALOTH,Bharat Rashtra Samithi,262416,1193,263609,23.77,S2916
3,PROFESSOR. AZMEERA SEETARAM NAIK,Bharatiya Janata Party,108775,1669,110444,9.96,S2916
4,ARUN KUMAR MYPATHI,All India Forward Bloc,38252,884,39136,3.53,S2916
5,RAGHU VARMA JATOTHU,Alliance of Democratic Reforms Party,11879,14,11893,1.07,S2916
6,DURGA PALVANCHA,Independent,10112,7,10119,0.91,S2916
7,KONETI SUJATHA,Bahujan Samaj Party,8058,35,8093,0.73,S2916
8,ANIL KUMAR BODA,Independent,6419,12,6431,0.58,S2916
9,CHANDA LINGAIAH,Independent,5075,25,5100,0.46,S2916
10,MOKALLA MURALIKRISHNA,Independent,4056,6,4062,0.37,S2916
11,SOYAM KANNA RAJU,Gondvana Gantantra Party,3727,28,3755,0.34,S2916
12,BANOTH PREM NAYAK [BPN],Independent,3707,5,3712,0.33,S2916
13,PAYAM.SINGARAJU,Independent,3192,4,3196,0.29,S2916
14,PADIGA YARRAIAH,Independent,2873,14,2887,0.26,S2916
15,DV NAIK,Independent,2780,1,2781,0.25,S2916
16,GUGULOTH SHEKAR NAIK,Independent,2533,9,2542,0.23,S2916
17,RAVVA. BHADRAMMA,Dharma Samaj Party,2234,10,2244,0.2,S2916
18,SODE VENKATESWARLU,Gondwana Dandkaranya Party,2154,18,2172,0.2,S2916
19,BANOTH LINGYA NAIK,Independent,1712,3,1715,0.15,S2916
20,BODA PRASHANTH,Independent,1588,2,1590,0.14,S2916
21,BURKA KRISHNAVENI,Socialist Party (India),1438,10,1448,0.13,S2916
22,BANOTHU LINGANNA,Blue India Party,1367,0,1367,0.12,S2916
23,VANKUDOTHU RAVI KUMAR (RAVANNA),Telangana Jaghir Party,1117,8,1125,0.1,S2916
24,NOTA,None of the Above,6511,80,6591,0.59,S2916
1,K. RAJASHEKAR BASAVARAJ HITNAL,Indian National Congress,661921,1590,663511,49.93,S108
2,DR . BASAVARAJ. K. SHARANAPPA,Bharatiya Janata Party,614866,2288,617154,46.44,S108
3,MALLIKARJUN HADAPAD,Independent,7310,4,7314,0.55,S108
4,SHANKARA,Bahujan Samaj Party,7031,12,7043,0.53,S108
5,KARADI BASAVARAJ,Independent,5868,9,5877,0.44,S108
6,RUKMINI,Independent,5279,3,5282,0.4,S108
7,SURESH. GOUDA MUNDINAMANE,Independent,4641,1,4642,0.35,S108
8,NAGARAJ KALAL,Independent,1992,2,1994,0.15,S108
9,KALAPPA YACHRAPPA BADIGER VISHWAKARMA,Independent,1967,15,1982,0.15,S108
10,PA.YA. GANESH,Independent,1892,3,1895,0.14,S108
11,HANAMESH . S . H. SHAKHAPUR,Independent,1247,1,1248,0.09,S108
12,KAREEMPASHA GACHCHINMANI.,Independent,1233,5,1238,0.09,S108
13,ANNOJI RAO. G,Sarva Janata Party,1113,4,1117,0.08,S108
14,SHARANAPPA,Socialist Unity Centre Of India (COMMUNIST),1097,9,1106,0.08,S108
15,NIRUPADI K GOMARSI,Karnataka Rashtra Samithi,891,9,900,0.07,S108
16,RAMZANBEE,All India Ulama Congress,800,6,806,0.06,S108
17,D DURGA PRASAD BYATARAYANAJI,Challengers Party,798,1,799,0.06,S108
18,C. SHARANA BASAPPA,Republican Party of India (Karnataka),770,6,776,0.06,S108
19,IMAMSAB JANGLISAB MULLA,Independent,728,5,733,0.06,S108
20,NOTA,None of the Above,3496,23,3519,0.26,S108
1,GODAM NAGESH,Bharatiya Janata Party,558936,9232,568168,45.98,S291
2,ATHRAM SUGUNA,Indian National Congress,472333,5183,477516,38.65,S291
3,ATHRAM SAKKU,Bharat Rashtra Samithi,136463,837,137300,11.11,S291
4,MALOTHU SYAMLAL NAYAK,Alliance of Democratic Reforms Party,7489,10,7499,0.61,S291
5,MESRAM JANGUBAPU,Bahujan Samaj Party,6689,55,6744,0.55,S291
6,RATHOD SUBASH,Independent,6434,94,6528,0.53,S291
7,BUKYA JAIVANTH RAO,Independent,6427,19,6446,0.52,S291
8,CHAVAN SUDHARSHAN,Anna YSR Congress Party,4618,26,4644,0.38,S291
9,GANGADEVI MESRAM,Dharma Samaj Party,3445,23,3468,0.28,S291
10,N. TIRUPATI,Vidhyarthula Rajakiya Party,2284,8,2292,0.19,S291
11,KODAPA VAMAN RAO,Gondwana Dandkaranya Party,1677,8,1685,0.14,S291
12,GEDAM. SAGAR,India Praja Bandhu Party,1537,8,1545,0.13,S291
13,NOTA,None of the Above,11650,112,11762,0.95,S291
1,DR.KALANIDHI VEERASWAMY,Dravida Munnetra Kazhagam,495733,1600,497333,55.11,S222
2,R. MANOHAR,All India Anna Dravida Munnetra Kazhagam,157631,480,158111,17.52,S222
3,R.C. PAUL KANAGARAJ,Bharatiya Janata Party,112628,690,113318,12.56,S222
4,AMUDINI,Naam Tamilar Katchi,95715,239,95954,10.63,S222
5,SARAH FATHIMA,Independent,5899,24,5923,0.66,S222
6,E. IQBAL,Bahujan Samaj Party,3471,15,3486,0.39,S222
7,MOORTHY. V,Independent,3131,6,3137,0.35,S222
8,SURIYAMUTHU,Independent,976,2,978,0.11,S222
9,C. SENAPATHI,Independent,850,0,850,0.09,S222
10,DILLI GANESH. E,Independent,735,1,736,0.08,S222
11,U. VENKATESH,Independent,709,5,714,0.08,S222
12,M. ZION RAJ,Independent,696,1,697,0.08,S222
13,A. AJITHKUMAR,Thakkam Katchi,671,2,673,0.07,S222
14,J. SEBASTIN,Socialist Unity Centre Of India (COMMUNIST),586,2,588,0.07,S222
15,AKSHAY,Naadaalum Makkal Katchi,563,3,566,0.06,S222
16,B. BALAMURUGAN,Independent,485,3,488,0.05,S222
17,K.PALANIAPPAN,Independent,460,2,462,0.05,S222
18,R. SENTHIL KUMAR,Independent,457,0,457,0.05,S222
19,MATHANKUMAR. G,Independent,390,0,390,0.04,S222
20,P. JAYASELAN,Independent,386,0,386,0.04,S222
21,M. KOLANJI,Independent,361,1,362,0.04,S222
22,B. ZAKIR HUSSAIN,Independent,354,1,355,0.04,S222
23,P. UMADEVI,Independent,346,0,346,0.04,S222
24,K.C.JAYAPRAKASH,Independent,334,0,334,0.04,S222
25,C. SRIDHAR,Independent,307,0,307,0.03,S222
26,T. MANOHARAN,Independent,293,0,293,0.03,S222
27,K. SAMPATH,Independent,268,1,269,0.03,S222
28,D. SRINIVASAN,Independent,260,1,261,0.03,S222
29,S. RAVIKUMAR,Republican Party of India  (Sivaraj),258,1,259,0.03,S222
30,T. KAVIYARASU,Independent,250,2,252,0.03,S222
31,SATHISH. B,Independent,245,1,246,0.03,S222
32,R.VINAYAGAMOORTHY,Independent,206,0,206,0.02,S222
33,D. KABILAN,Independent,203,6,209,0.02,S222
34,P. MARIMUTHU,Independent,171,1,172,0.02,S222
35,V.MADHAN MOHAN,Independent,163,0,163,0.02,S222
36,NOTA,None of the Above,13139,69,13208,1.46,S222
1,DR. MAHESH SHARMA,Bharatiya Janata Party,855413,2416,857829,59.69,S2413
2,DR. MAHENDRA SINGH NAGAR,Samajwadi Party,297697,660,298357,20.76,S2413
3,RAJENDRA SINGH SOLANKI,Bahujan Samaj Party,250962,653,251615,17.51,S2413
4,BHIM PRAKASH JIGYASU,Viro Ke Vir Indian Party,3873,2,3875,0.27,S2413
5,MOHD. MUMTAJ AALAM,Independent,2818,3,2821,0.2,S2413
6,SHIVAM ASHUTOSH,Independent,2637,4,2641,0.18,S2413
7,MANISH KUMAR DWIVEDI,Akhil Bhartiya Parivar Party,1769,3,1772,0.12,S2413
8,KISHOR SINGH,National Party,1739,28,1767,0.12,S2413
9,MAHKAR SINGH,Independent,1118,6,1124,0.08,S2413
10,KM. SHALU,Loktantrik Janshakti Party,1020,30,1050,0.07,S2413
11,PARAG KAUSHIK,Independent,945,1,946,0.07,S2413
12,NARESH NAUTIYAL,Bhartiya Rashtriya Jansatta,931,10,941,0.07,S2413
13,RAN SINGH DUDEE,Super Power India Party,905,3,908,0.06,S2413
14,RAJEEV MISHRA,Jai Hind National Party,642,15,657,0.05,S2413
15,NARAVEDASHVAR,Subhashwadi Bhartiya Samajwadi Party (Subhas Party),615,2,617,0.04,S2413
16,NOTA,None of the Above,10286,38,10324,0.72,S2413
1,PRIYANKA SATISH JARKIHOLI,Indian National Congress,710823,2638,713461,51.21,S101
2,ANNASAHEB SHANKAR JOLLE,Bharatiya Janata Party,618168,4459,622627,44.69,S101
3,KALLOLIKAR SHAMBHU KRISHNA,Independent,25351,115,25466,1.83,S101
4,SAMMED SARADAR VARDHAMANE,Independent,5351,2,5353,0.38,S101
5,SHRENIK ANNASAHEB JANGATE,Independent,5179,2,5181,0.37,S101
6,APPASAHEB SHRIPATI KURANE,Sarva Janata Party,4635,19,4654,0.33,S101
7,VILAS MANNUR,Independent,4143,7,4150,0.3,S101
8,SATTEPPA DASHARATH KALELI,Bharatheeya Jawan Kisan Party,1304,15,1319,0.09,S101
9,YASIN SHIRAJUDDIN PATAKI,Independent,1279,2,1281,0.09,S101
10,KASHINATH KALLAPPA KURANI,Independent,1097,11,1108,0.08,S101
11,MAHESH ASHOK KASAR,Independent,1002,7,1009,0.07,S101
12,MOHAN GURAPPA MOTANNAVAR,Independent,938,8,946,0.07,S101
13,KUMAR SAMBHAJI DONGARE,Karnataka Rashtra Samithi,930,11,941,0.07,S101
14,PAVANKUMAR BABURAV MALAGE,Bahujan Bharat Party,655,11,666,0.05,S101
15,DR|| KADAYYA HIREMATH (SWAMIJI),Independent,642,5,647,0.05,S101
16,BHIMASEN DATTU SANADI,Independent,614,5,619,0.04,S101
17,GAJANAN L. PUJARI,Independent,591,9,600,0.04,S101
18,JITENDRA SUBHASH NERLE,Independent,452,5,457,0.03,S101
19,NOTA,None of the Above,2571,37,2608,0.19,S101
1,DINESH CHANDRA YADAV,Janata Dal  (United),639758,891,640649,52.96,S0413
2,DA KUMAR CHANDRADEEP,Rashtriya Janata Dal,464982,1133,466115,38.53,S0413
3,SURESHWAR PODDAR,Aadarsh Mithila Party,15423,11,15434,1.28,S0413
4,MD ARSHAD HUSSAIN,Bahujan Samaj Party,12947,44,12991,1.07,S0413
5,JAWAHAR LAL JAISWAL,Socialist Unity Centre Of India (COMMUNIST),11320,2,11322,0.94,S0413
6,UCHESHWAR PANDIT,Samajhdar Party,11127,22,11149,0.92,S0413
7,PRO KAMESHWAR YADAV,Bharatiya Jan Kranti Dal (Democratic),10665,9,10674,0.88,S0413
8,AJABLAL MEHTA,Yuva Krantikari Party,8720,16,8736,0.72,S0413
9,NOTA,None of the Above,32557,68,32625,2.7,S0413
1,KALYAN VAIJINATHRAO KALE,Indian National Congress,605504,2393,607897,44.59,S1318
2,DANVE RAOSAHEB DADARAO,Bharatiya Janata Party,495809,2130,497939,36.52,S1318
3,MANGESH SANJAY SABLE,Independent,155335,595,155930,11.44,S1318
4,BAKALE PRABHAKAR DEVGAN,Vanchit Bahujan  Aaghadi,37678,132,37810,2.77,S1318
5,BABASAHEB SANTUKRAO SHELKE,Samata Party,9564,6,9570,0.7,S1318
6,CHABUKSWAR RAHUL NIRANJAN,Independent,6330,7,6337,0.46,S1318
7,NIVRUTTI VISHWNATH BANSODE,Bahujan Samaj Party,5974,34,6008,0.44,S1318
8,DIPAK BHIMRAO BORHADE,Samnak Janta Party,5498,24,5522,0.41,S1318
9,TANAJI TUKARAM BHOJANE,Independent,4933,15,4948,0.36,S1318
10,KAMBLE MAROTI DASHARATH,Independent,3712,16,3728,0.27,S1318
11,RAJENDRA NAMDEO MAGRE,Independent,2873,2,2875,0.21,S1318
12,MANOJ NEMINATH KOLTE,Independent,2734,3,2737,0.2,S1318
13,MUKESH PRABHAT RATHOD,Akhil Bhartiya Parivar Party,2580,11,2591,0.19,S1318
14,BABASAHEB PATIL SHINDE,Independent,2413,4,2417,0.18,S1318
15,KADUBA MHATARBA INGLE,Independent,1962,5,1967,0.14,S1318
16,AJHAR ANWAR SAYYAD,Independent,1541,5,1546,0.11,S1318
17,AHMAD RAHIM SAIKH BAGWAN,Independent,1390,4,1394,0.1,S1318
18,ADV. YOGESH DATTU GULLAPELLI,Independent,1339,3,1342,0.1,S1318
19,BHAGWAN SAHEBRAO REGUDE,Hindustan Janta Party,1173,1,1174,0.09,S1318
20,DNYANESHWAR DAGDUJI NADE,Independent,1142,1,1143,0.08,S1318
21,DHANANJAY RUPRAOJI KAKDE (PATIL),Bharatheeya Jawan Kisan Party,1132,7,1139,0.08,S1318
22,ABDUL RAFIQ ABDUL LATIF,Independent,1045,2,1047,0.08,S1318
23,SHYAM RUSTUMRAO SHIRSATH,Bahujan Republican  Socialist Party,972,2,974,0.07,S1318
24,RATAN ASARAM LANDGE,Independent,646,1,647,0.05,S1318
25,VIKAS CHHAGAN LAHANE,Independent,644,0,644,0.05,S1318
26,SHAM PAWALS RUPEKAR,Independent,544,2,546,0.04,S1318
27,NOTA,None of the Above,3504,33,3537,0.26,S1318
1,PROF S P SINGH BAGHEL,Bharatiya Janata Party,597061,2336,599397,53.34,S2418
2,SURESH CHAND KARDAM,Samajwadi Party,326644,1459,328103,29.2,S2418
3,POOJA AMROHI,Bahujan Samaj Party,175810,664,176474,15.7,S2418
4,ARAM SINGH,Peoples Party of India (Democratic),4130,13,4143,0.37,S2418
5,KULDEEP KUMAR,Bharatiya Kisan Parivartan Party,1997,5,2002,0.18,S2418
6,MAHENDRA SINGH,Independent,1779,6,1785,0.16,S2418
7,POOJA,Independent,1363,7,1370,0.12,S2418
8,SARVESH KUMAR,Bharatiya Majdoor Janta Party,1123,10,1133,0.1,S2418
9,AMBEDAKARI HASANURAM AMBEDAKARI,Independent,927,6,933,0.08,S2418
10,JITENDRA GAUTAM,Lokpriya Rashtrawadi Party,780,2,782,0.07,S2418
11,CHANDRA PAL,Adarsh Samaj Party,640,3,643,0.06,S2418
12,NOTA,None of the Above,6929,85,7014,0.62,S2418
1,G. KUMAR NAIK.,Indian National Congress,669413,1553,670966,51.63,S106
2,RAJA AMARESHWARA NAIK.,Bharatiya Janata Party,588833,2352,591185,45.49,S106
3,S. NARASANNA GOUDA NAYAKA,Bahujan Samaj Party,9275,14,9289,0.71,S106
4,BASAVA PRABHU. MEDA,Karnataka Rashtra Samithi,5173,8,5181,0.4,S106
5,AMARESH,Independent,4459,6,4465,0.34,S106
6,YALLAMMA DALAPATHI,Independent,3629,5,3634,0.28,S106
7,MEDHAR SHAMRAO,Bhartiya Jan Samrat Party,2625,15,2640,0.2,S106
8,RAMALINGAPPA,Socialist Unity Centre Of India (COMMUNIST),2404,5,2409,0.19,S106
9,NOTA,None of the Above,9825,25,9850,0.76,S106
1,RAHUL GANDHI,Indian National Congress,642299,5146,647445,59.69,S114
2,ANNIE RAJA,Communist Party of India,280594,2429,283023,26.09,S114
3,K SURENDRAN,Bharatiya Janata Party,139868,1177,141045,13,S114
4,P.R KRISHNANKUTTY,Bahujan Samaj Party,1946,27,1973,0.18,S114
5,SATHYAN K.P,Independent,1017,42,1059,0.1,S114
6,SINOJ A.C,Independent,885,18,903,0.08,S114
7,PRASEETHA AZHIKODE,Independent,814,26,840,0.08,S114
8,AJEEB MUHAMMED,Independent,796,8,804,0.07,S114
9,P RADHAKRISHNAN,Independent,555,7,562,0.05,S114
10,NOTA,None of the Above,6932,67,6999,0.65,S114
1,ALFRED KANNGAM S ARTHUR,Indian National Congress,381813,3141,384954,48.32,S142
2,KACHUI TIMOTHY ZIMIK,Naga Peoples Front,298358,1178,299536,37.6,S142
3,S KHO JOHN,Independent,89677,233,89910,11.28,S142
4,ALYSON ABONMAI,Independent,14865,245,15110,1.9,S142
5,NOTA,None of the Above,6530,695,7225,0.91,S142
1,ANURAG SINGH THAKUR,Bharatiya Janata Party,593055,14013,607068,57.97,S083
2,SATPAL RAIZADA,Indian National Congress,414828,9883,424711,40.55,S083
3,HEM RAJ,Bahujan Samaj Party,2694,64,2758,0.26,S083
4,JAGDEEP KUMAR,Rashtriya Devbhumi Party,1738,26,1764,0.17,S083
5,SURENDER KUMAR GAUTAM,Independent,1401,9,1410,0.13,S083
6,SUBEDAR MAJOR KULWANT SINGH PATIAL,Bharatheeya Jawan Kisan Party,1176,63,1239,0.12,S083
7,NAND LAL,Independent,978,41,1019,0.1,S083
8,SUMIT RANA,Akhil Bhartiya Parivar Party,666,9,675,0.06,S083
9,RAMESH CHAND SARTHI,Independent,544,16,560,0.05,S083
10,ARUN ANKESH SYAL,Ekam Sanatan Bharat Dal,412,21,433,0.04,S083
11,GARIB DASS KATOCH,Independent,210,36,246,0.02,S083
12,GOPI CHAND ATTARI,Independent,168,34,202,0.02,S083
13,NOTA,None of the Above,5100,78,5178,0.49,S083
1,DR JAYANTA KUMAR ROY,Bharatiya Janata Party,763236,3332,766568,48.57,S253
2,NIRMAL CHANDRA ROY,All India Trinamool Congress,677496,2379,679875,43.07,S253
3,DEBRAJ BARMAN,Communist Party of India  (Marxist),73629,463,74092,4.69,S253
4,SHIPRA RAY HAKIM,Independent,9890,17,9907,0.63,S253
5,BINOD MALLICK,Bahujan Samaj Party,8537,29,8566,0.54,S253
6,HAREKRISHNA SARKAR,Independent,5837,11,5848,0.37,S253
7,MAHESWAR BARMAN,Independent,4254,13,4267,0.27,S253
8,RAM PRASAD MANDAL,Socialist Unity Centre Of India (COMMUNIST),3815,20,3835,0.24,S253
9,MANABENDRA ROY,Kamatapur People’s Party (United),2899,51,2950,0.19,S253
10,NIRODE CHANDRA ADHIKARY,Independent,2504,13,2517,0.16,S253
11,ADHIR CHANDRA BARMAN,Independent,1911,16,1927,0.12,S253
12,RANJIT BARMAN,Mulnibasi Party of India,1180,9,1189,0.08,S253
13,NOTA,None of the Above,16807,41,16848,1.07,S253
1,DR RANI SRI KUMAR,Dravida Munnetra Kazhagam,423025,2654,425679,40.97,S2237
2,DR K KRISHNASAMY,All India Anna Dravida Munnetra Kazhagam,228290,1190,229480,22.08,S2237
3,B JOHN PANDIAN,Bharatiya Janata Party,206982,1843,208825,20.1,S2237
4,ESAI MATHIVANAN,Naam Tamilar Katchi,128750,1585,130335,12.54,S2237
5,KARPAGAVALLI P,Independent,6200,114,6314,0.61,S2237
6,T MAHESHKUMAR,Bahujan Samaj Party,3526,28,3554,0.34,S2237
7,RAMASAMY P,Viro Ke Vir Indian Party,3395,17,3412,0.33,S2237
8,M MANMATHAN,Independent,3276,2,3278,0.32,S2237
9,A SEETHA,Bahujan Dravida Party,2476,0,2476,0.24,S2237
10,KRISHNASAMY,Independent,1828,5,1833,0.18,S2237
11,M UMAMAHESWARI,Desiya Makkal Sakthi Katchi,1626,29,1655,0.16,S2237
12,A MUTHAIAH,Independent,1440,17,1457,0.14,S2237
13,P KRISHNASAMY,Independent,1342,8,1350,0.13,S2237
14,ARUMUGASWAMI M,Independent,1292,21,1313,0.13,S2237
15,RAJA SEKAR,Independent,982,11,993,0.1,S2237
16,NOTA,None of the Above,16877,288,17165,1.65,S2237
1,DR. PRASHANT YADAORAO PADOLE,Indian National Congress,581678,5735,587413,47.56,S1311
2,SUNIL BABURAO MENDHE,Bharatiya Janata Party,546222,3811,550033,44.53,S1311
3,KUMBHALKAR SANJAY BHAIYY,Bahujan Samaj Party,25104,358,25462,2.06,S1311
4,SANJAY GAJANAN KEWAT,Vanchit Bahujan  Aaghadi,24528,330,24858,2.01,S1311
5,SEWAKBHAU NIRDHAN WAGHAYE,Independent,12899,204,13103,1.06,S1311
6,AJAYKUMAR BHARTIYA,Akhil Bhartiya Parivar Party,3998,59,4057,0.33,S1311
7,SUMIT VIJAY PANDE,Independent,3719,0,3719,0.3,S1311
8,VIRENDRAKUMAR KASTURCHAND JAISWAL,Independent,2382,7,2389,0.19,S1311
9,DEVILAL SUKHRAM NEPALE,Peoples Party of India (Democratic),2000,9,2009,0.16,S1311
10,DR. AKASH MADHUKAR JIBHAKATE,Independent,1972,9,1981,0.16,S1311
11,VILAS BABURAO LENDE,Lok Swarajya Party,1624,25,1649,0.13,S1311
12,VILAS JIYALAL RAUT,Independent,1611,5,1616,0.13,S1311
13,BENIRAM RAMCHAND FULBANDHE,Independent,1482,15,1497,0.12,S1311
14,PRADEEP  DHOBALE,Independent,1163,33,1196,0.1,S1311
15,SURYAKIRAN ISHWAR NANDAGAWALI,Independent,1132,30,1162,0.09,S1311
16,ITWALE SHARAD MARTAND,Independent,1020,8,1028,0.08,S1311
17,TULSIRAM URKUDA GEDAM,Independent,831,11,842,0.07,S1311
18,CHAITRAM DASHARATH KOKASE,Independent,780,11,791,0.06,S1311
19,NOTA,None of the Above,10106,162,10268,0.83,S1311
1,DHARAMBIR SINGH,Bharatiya Janata Party,582735,5929,588664,49.74,S078
2,RAO DAN SINGH,Indian National Congress,541926,5228,547154,46.24,S078
3,BAHADUR SINGH,Jannayak Janta Party,15076,189,15265,1.29,S078
4,SUNIL KUMAR SHARMA,Bahujan Samaj Party,6239,97,6336,0.54,S078
5,SUBHASH,Rashtrawadi Janlok Party (Satya),4663,32,4695,0.4,S078
6,HEMANT,Independent,3876,5,3881,0.33,S078
7,SEEMA,Independent,2961,18,2979,0.25,S078
8,VED PRAKASH,Independent,1897,3,1900,0.16,S078
9,ANAND KUMAR,Bharatheeya Jawan Kisan Party,1642,26,1668,0.14,S078
10,YOGBIR SINGH,Independent,1473,5,1478,0.12,S078
11,VARSHA,Independent,993,60,1053,0.09,S078
12,BALWAN,Peoples Party of India (Democratic),854,3,857,0.07,S078
13,ROHTASH,Socialist Unity Centre Of India (COMMUNIST),637,3,640,0.05,S078
14,JAI SINGH,Independent,442,9,451,0.04,S078
15,BHARAT BHUSHAN,Bhartiya Shakti Chetna Party,440,3,443,0.04,S078
16,ENGINEER MAHAVIR SINGH YADAV,Independent,406,9,415,0.04,S078
17,JAGDISH,Independent,219,10,229,0.02,S078
18,NOTA,None of the Above,5188,99,5287,0.45,S078
1,KODIKUNNIL SURESH,Indian National Congress,362209,7307,369516,41.29,S1116
2,ADV ARUN KUMAR C A,Communist Party of India,352708,5940,358648,40.07,S1116
3,BAIJU KALASALA,Bharath Dharma Jana Sena,140830,2154,142984,15.98,S1116
4,C MONICHEN,Independent,4893,81,4974,0.56,S1116
5,SANTHOSH PALATHUMPADAN,Bahujan Samaj Party,4183,123,4306,0.48,S1116
6,SURESH NOORANAD,Ambedkarite Party of India,1441,64,1505,0.17,S1116
7,K BIMALJI,Socialist Unity Centre Of India (COMMUNIST),1336,34,1370,0.15,S1116
8,MANTHARA VELAYUDHAN,Independent,910,19,929,0.1,S1116
9,KOZHUVASSERIL SURESH,Independent,836,20,856,0.1,S1116
10,NOTA,None of the Above,9640,243,9883,1.1,S1116
1,RUDRA NARAYAN PANY,Bharatiya Janata Party,593907,4814,598721,50.24,S189
2,ABINASH SAMAL,Biju Janata Dal,520144,2010,522154,43.82,S189
3,SASHMITA BEHERA,Indian National Congress,34052,678,34730,2.91,S189
4,PRAFULLA KUMAR NAIK,Bahujan Samaj Party,4850,45,4895,0.41,S189
5,MAHESWAR SAHOO,Independent,4614,15,4629,0.39,S189
6,MANASI SWAIN,Socialist Unity Centre Of India (COMMUNIST),3376,8,3384,0.28,S189
7,PRIYABRATA GARNAIK,Independent,2904,5,2909,0.24,S189
8,JANARDAN NAIK,Independent,2647,6,2653,0.22,S189
9,KAILAS CHANDRA PRADHAN,Independent,2205,8,2213,0.19,S189
10,SWAPNA RANI JAMES,Utkal Samaj,1603,5,1608,0.13,S189
11,NOTA,None of the Above,13731,46,13777,1.16,S189
1,SUDHEER GUPTA,Bharatiya Janata Party,942249,3512,945761,65.98,S1223
2,DILIP SINGH GURJAR,Indian National Congress,443622,1484,445106,31.05,S1223
3,KANHAIYALAL MALVIYA,Bahujan Samaj Party,10456,56,10512,0.73,S1223
4,ISMAIL KHAN MAIV,Independent,8810,16,8826,0.62,S1223
5,SUSHIL,Independent,3432,7,3439,0.24,S1223
6,SAEED AHAMAD,Independent,3165,2,3167,0.22,S1223
7,MURALIDHAR,Independent,2682,14,2696,0.19,S1223
8,VIJAY RANN,Independent,2314,9,2323,0.16,S1223
9,NOTA,None of the Above,11615,47,11662,0.81,S1223
1,RAJIV PRATAP RUDY,Bharatiya Janata Party,470234,1518,471752,46.18,S0420
2,ROHINI ACHARYA,Rashtriya Janata Dal,456763,1328,458091,44.84,S0420
3,LAXAMAN PRAO YADAV,Independent,22041,2,22043,2.16,S0420
4,SHAK NAUSHAD,Independent,16101,2,16103,1.58,S0420
5,AVINASH KUMAR,Bahujan Samaj Party,14708,62,14770,1.45,S0420
6,RAGHWENDRA PRATAP SINGH,Independent,5165,2,5167,0.51,S0420
7,GAJENDRA PRASAD CHAURSIYA,Janhit Kisan Party,5025,5,5030,0.49,S0420
8,SHATRUDHAN TIWARY,Bhartiya Sarthak Party,3661,26,3687,0.36,S0420
9,MOHAMAD SALIM,Independent,3148,3,3151,0.31,S0420
10,ARTI KUMARI,Independent,3009,14,3023,0.3,S0420
11,PRABHAT KUMAR,Independent,2302,4,2306,0.23,S0420
12,BARUN KUMAR DAS,Gana Suraksha Party,1770,5,1775,0.17,S0420
13,GYANI KUMAR SHARMA,Bharatiya Ekta Dal,1699,5,1704,0.17,S0420
14,RAJESH KUSHWAHA,Bhartiya Lok Chetna Party,1486,3,1489,0.15,S0420
15,NOTA,None of the Above,11382,35,11417,1.12,S0420
1,GENIBEN NAGAJI THAKOR,Indian National Congress,667072,4811,671883,48.83,S062
2,DR. REKHABEN HITESHBHAI CHAUDHARI,Bharatiya Janata Party,635760,5717,641477,46.62,S062
3,MANSUNGBHAI MASHRUBHAI PARMAR,Bahujan Samaj Party,9900,29,9929,0.72,S062
4,RATHOD MAVJI BHEMAJI,Independent,7690,6,7696,0.56,S062
5,SHRIMALI ASHOKBHAI BALCHANDBHAI,Independent,5473,8,5481,0.4,S062
6,JASUBHAI GAMAR,Bharat Adivasi Party,4615,11,4626,0.34,S062
7,PATEL PIYUSHBHAI KARSHANBHAI,Bharatiya Yuva Jan Ekta Party,3503,10,3513,0.26,S062
8,BAJAG LASHABHAI LAVAJIBHAI,Independent,2994,15,3009,0.22,S062
9,PRAVINBHAI ISHVARBHAI CHAUHAN,Swatantrata Abhivyakti Party,1822,1,1823,0.13,S062
10,IBRAHIMBHAI PARASANI,Independent,1588,3,1591,0.12,S062
11,PARMAR CHHAGANCHANDRARAJ,Independent,1369,5,1374,0.1,S062
12,CHETANKUMAR KESHAVLAL OZA,Independent,1321,13,1334,0.1,S062
13,NOTA,None of the Above,22034,133,22167,1.61,S062
1,DR. RICKY ANDREW J. SYNGKON,Voice of the People Party,569156,1922,571078,55.02,S151
2,VINCENT H. PALA,Indian National Congress,198045,1123,199168,19.19,S151
3,DR. MAZEL AMPAREEN LYNGDOH,National People's Party,185531,957,186488,17.97,S151
4,ROBERTJUNE KHARJAHRIN,United Democratic Party,44278,285,44563,4.29,S151
5,PROF. LAKHON KMA,Independent,18522,60,18582,1.79,S151
6,PETER SHALLAM,Independent,6975,49,7024,0.68,S151
7,NOTA,None of the Above,10944,64,11008,1.06,S151
1,K. C VENUGOPAL,Indian National Congress,398246,6314,404560,38.21,S1115
2,A. M ARIFF,Communist Party of India  (Marxist),335596,5451,341047,32.21,S1115
3,SOBHA SURENDRAN,Bharatiya Janata Party,295841,3807,299648,28.3,S1115
4,MURALEEDHARAN KONCHERILLAM,Bahujan Samaj Party,1578,48,1626,0.15,S1115
5,ARJUNAN,Socialist Unity Centre Of India (COMMUNIST),1301,18,1319,0.12,S1115
6,VAYALAR RAJEEVAN,Bahujan Dravida Party,674,1,675,0.06,S1115
7,ADV.K.M SHAJAHAN,Independent,627,55,682,0.06,S1115
8,SHAJAHAN V.A.     S/O ABDUL AZEES,Independent,553,23,576,0.05,S1115
9,SATHEESH SHENOI,Independent,473,9,482,0.05,S1115
10,JAYAKRISHNAN P,Independent,329,56,385,0.04,S1115
11,JYOTHI ABRAHAM,Independent,328,10,338,0.03,S1115
12,NOTA,None of the Above,7252,113,7365,0.7,S1115
1,ROOP KUMARI CHOUDHARY,Bharatiya Janata Party,701291,2368,703659,53.06,S269
2,TAMRADHWAJ SAHU,Indian National Congress,556764,1439,558203,42.09,S269
3,PROFESSOR SURESH SAHU,Independent,11885,3,11888,0.9,S269
4,BASANT SINHA,Bahujan Samaj Party,8823,37,8860,0.67,S269
5,REKHRAM BAGH,Independent,7877,1,7878,0.59,S269
6,GANESH RAM DHRUW,Hamar Raj Party,6626,25,6651,0.5,S269
7,SANTOSH DARCHAND BANJARE,Independent,6049,5,6054,0.46,S269
8,MUKESH KUMAR AGRAWAL,Independent,3689,2,3691,0.28,S269
9,SUKHNANDAN  DESHKAR,Independent,3554,1,3555,0.27,S269
10,NITESH KUMAR RATRE,Sunder Samaj Party,2366,7,2373,0.18,S269
11,DR. VIRENDRA CHAUDHRI,Bhartiya Shakti Chetna Party,2093,6,2099,0.16,S269
12,KALIYA PRASAD SETH,Independent,1528,3,1531,0.12,S269
13,MAHESH SWARN,Independent,1484,2,1486,0.11,S269
14,CHAMPA LAL PATEL GURUJI DHARTI PAKD,Right to Recall Party,1376,3,1379,0.1,S269
15,FARID QURAISHI,Gondvana Gantantra Party,1074,3,1077,0.08,S269
16,ISHWAR MARKANDE,Independent,957,0,957,0.07,S269
17,NARAD PRASAD NISHAD,Shakti Sena (Bharat Desh),897,2,899,0.07,S269
18,NOTA,None of the Above,3801,39,3840,0.29,S269
1,KHAN SAUMITRA,Bharatiya Janata Party,677320,2810,680130,44.93,S2537
2,SUJATA MONDAL,All India Trinamool Congress,671148,3415,674563,44.56,S2537
3,SITAL CHANDRA KAIBARTYA,Communist Party of India  (Marxist),104895,516,105411,6.96,S2537
4,SADANANDA MANDAL,Socialist Unity Centre Of India (COMMUNIST),16046,28,16074,1.06,S2537
5,JOYDEV DHANK,Bahujan Samaj Party,9027,52,9079,0.6,S2537
6,BASUDEB SIKARI,Independent,5093,13,5106,0.34,S2537
7,NARENDRANATH RAY,Independent,4360,17,4377,0.29,S2537
8,NOTA,None of the Above,19062,70,19132,1.26,S2537
1,SHANTANU THAKUR,Bharatiya Janata Party,716952,2553,719505,48.19,S2514
2,BISWAJIT DAS S/O LATE BIJAY KRISHNA DAS,All India Trinamool Congress,643653,2159,645812,43.25,S2514
3,PRADIPKUMAR BISWAS,Indian National Congress,64859,317,65176,4.37,S2514
4,DIPAK MAJUMDAR,All India Secular Front,19199,17,19216,1.29,S2514
5,SUJATA BAIRAGI,Independent,9649,4,9653,0.65,S2514
6,JASHAJIT SARKHEL,Independent,7829,4,7833,0.52,S2514
7,CHANDAN MALLICK,Bahujan Samaj Party,5905,30,5935,0.4,S2514
8,PRANITA MANDAL,Independent,2407,4,2411,0.16,S2514
9,SUMITA PODDAR,Independent,2347,7,2354,0.16,S2514
10,BISWAJIT DAS S/O LATE BALARAM DAS,Independent,2241,7,2248,0.15,S2514
11,PATIT PABAN MANDAL,Socialist Unity Centre Of India (COMMUNIST),2140,29,2169,0.15,S2514
12,SAMARESH BISWAS,Party for Democratic Socialism,1562,3,1565,0.1,S2514
13,BISWAJIT DAS,Independent,1257,15,1272,0.09,S2514
14,KALYAN SARKAR,Independent,676,15,691,0.05,S2514
15,SUBRATA BISWAS,Guruchand Sena Dal,581,2,583,0.04,S2514
16,NOTA,None of the Above,6635,50,6685,0.45,S2514
1,BUNTY VIVEK SAHU,Bharatiya Janata Party,643489,1249,644738,49.41,S1216
2,NAKUL KAMALNATH,Indian National Congress,529931,1189,531120,40.7,S1216
3,DEVIRAM URF DEV RAVEN BHALAVI,Gondvana Gantantra Party,55854,134,55988,4.29,S1216
4,UMAKANT BANDEWAR,Bahujan Samaj Party,11802,21,11823,0.91,S1216
5,KAPIL SONI,Rashtriya Gondvana Party,9634,4,9638,0.74,S1216
6,SIRAJ SHEKH,Independent,9567,1,9568,0.73,S1216
7,PAWANSHAH SARYAM,Independent,6612,9,6621,0.51,S1216
8,SUBHASH SHUKLA,Independent,5768,1,5769,0.44,S1216
9,RAJENDRA DONGRE,Independent,4628,4,4632,0.35,S1216
10,GOVIND BHALAVI,Independent,4022,7,4029,0.31,S1216
11,MOHD. PARVEZ QURESHI,Independent,3818,10,3828,0.29,S1216
12,AJAY BARKADE,Independent,2491,4,2495,0.19,S1216
13,KUSHWAHA RAJESH TANTRIK,Ahinsa Samaj Party,1695,3,1698,0.13,S1216
14,""" PRAKASH ALIAS BANTY "" PARTETI",Rashtra Samarpan Party,1652,2,1654,0.13,S1216
15,FOGAL BANSOD,Republican Party of India (A),1322,1,1323,0.1,S1216
16,NOTA,None of the Above,9887,16,9903,0.76,S1216
1,ADV ADOOR PRAKASH,Indian National Congress,323273,4778,328051,33.29,S1119
2,V JOY,Communist Party of India  (Marxist),321715,5652,327367,33.22,S1119
3,V  MURALEEDHARAN,Bharatiya Janata Party,307710,4069,311779,31.64,S1119
4,SURABHI S,Bahujan Samaj Party,4485,39,4524,0.46,S1119
5,PRAKASH P L,Independent,1762,52,1814,0.18,S1119
6,SANTHOSH K,Independent,1146,58,1204,0.12,S1119
7,PRAKASH S,Independent,745,66,811,0.08,S1119
8,NOTA,None of the Above,9681,110,9791,0.99,S1119
1,GOPINATH K,Indian National Congress,491131,1752,492883,42.27,S229
2,JAYAPRAKASH V,All India Anna Dravida Munnetra Kazhagam,299300,1097,300397,25.76,S229
3,NARASIMHAN C,Bharatiya Janata Party,212859,1266,214125,18.36,S229
4,VIDHYA RANI,Naam Tamilar Katchi,106260,823,107083,9.18,S229
5,ARUMUGAM M,Bharatiya Praja Aikyata Party,6118,36,6154,0.53,S229
6,DR.SHANMUGAM .A.R,Independent,5577,6,5583,0.48,S229
7,ESHWARAN C,Independent,4126,2,4128,0.35,S229
8,TAMILSELVAN S,Bahujan Samaj Party,3665,33,3698,0.32,S229
9,SWAMINATHAN T G,Aravor Munnetra Kazhagam,1969,9,1978,0.17,S229
10,MANI K,Chennai Youth Party,1964,8,1972,0.17,S229
11,SRINIVASAN K,Independent,1619,2,1621,0.14,S229
12,VENKATESHKUMAR M,Independent,1585,5,1590,0.14,S229
13,ALBERT FRANCIS XAVIER S,Independent,1422,1,1423,0.12,S229
14,SARAVANAKUMAR A,Independent,1163,6,1169,0.1,S229
15,ANAND KUMAR A,Independent,1157,3,1160,0.1,S229
16,SUBRAMANI M,Tamilar Makkal Katchi,1156,39,1195,0.1,S229
17,ANNADURAI K,Independent,1154,6,1160,0.1,S229
18,MAHARAJAN G,Independent,991,4,995,0.09,S229
19,JAGADHEESAN C,Viro Ke Vir Indian Party,897,3,900,0.08,S229
20,VIJAYAKUMAR K P,Anaithu India Makkal Katchi,891,46,937,0.08,S229
21,DEEKSHITH M,Karunaadu Party,817,7,824,0.07,S229
22,RAMESH A,Independent,816,3,819,0.07,S229
23,RAJESHWARI B.H.,Independent,793,6,799,0.07,S229
24,CHANDRAMOHAN K.M.,Independent,789,3,792,0.07,S229
25,DEVAPPA Y,Independent,717,7,724,0.06,S229
26,VEERASAMY C,Independent,656,4,660,0.06,S229
27,YUVARAJ K P U,Independent,402,3,405,0.03,S229
28,NOTA,None of the Above,10893,89,10982,0.94,S229
1,CAPTAIN BRIJESH CHOWTA,Bharatiya Janata Party,760130,4002,764132,53.97,S1017
2,PADMARAJ.R.POOJARY,Indian National Congress,612103,2821,614924,43.43,S1017
3,KANTHAPPA ALANGAR,Bahujan Samaj Party,4202,30,4232,0.3,S1017
4,DURGA PRASAD,Karunada Sevakara Party,2578,14,2592,0.18,S1017
5,SUPREETH KUMAR POOJARY  KATEEL,Independent,1884,17,1901,0.13,S1017
6,MAXIM PINTO,Independent,1654,36,1690,0.12,S1017
7,PRAJAAKEEYA MANOHARA,Uttama Prajaakeeya Party,964,7,971,0.07,S1017
8,DEEPAK RAJESH COELHO,Independent,950,26,976,0.07,S1017
9,RANJINI. M,Karnataka Rashtra Samithi,758,18,776,0.05,S1017
10,NOTA,None of the Above,23515,61,23576,1.67,S1017
1,SANJAY UTTAMRAO DESHMUKH,Shiv Sena (Uddhav Balasaheb Thackrey),591899,2908,594807,48.53,S1314
2,RAJSHRITAI HEMANT PATIL (MAHALLE),Shiv Sena,498514,1820,500334,40.83,S1314
3,ANIL JAYRAM RATHOD,Samnak Janta Party,56175,215,56390,4.6,S1314
4,HARISING (HARIBHAU) NASARU RATHOD,Bahujan Samaj Party,17256,140,17396,1.42,S1314
5,SANGITA DINESH CHAVHAN,Independent,7169,11,7180,0.59,S1314
6,RAMDAS BAJIRAO GHODAM,Independent,6776,5,6781,0.55,S1314
7,VINOD PANJABRAO NANDAGAVALI,Independent,6291,7,6298,0.51,S1314
8,SANDIP SAMPAT SHINDE,Independent,5511,3,5514,0.45,S1314
9,DHARAM DILIPSING THAKUR,Sanman Rajkiya Paksha,4539,16,4555,0.37,S1314
10,AMOL KOMAWAR,Hindrashtra Sangh,3364,13,3377,0.28,S1314
11,UTTAM ONKAR INGOLE,Peoples Party of India (Democratic),2958,17,2975,0.24,S1314
12,MANOJ MAHADEORAO GEDAM,Independent,2783,11,2794,0.23,S1314
13,NUR ALI MAHEBUB ALI SHAH,Independent,1951,7,1958,0.16,S1314
14,DR ARJUNKUMAR SITARAM RATHOD,Independent,1857,6,1863,0.15,S1314
15,PRO KISAN RAMRAO AMBURE,Independent,1705,15,1720,0.14,S1314
16,DIKSHANT NAMDEVRAO SAWAIKAR,Independent,1095,8,1103,0.09,S1314
17,GOKUL PREMDAS CHAVHAN,Independent,1091,3,1094,0.09,S1314
18,NOTA,None of the Above,9316,75,9391,0.77,S1314
1,CHANDAN CHAUHAN,Rashtriya Lok Dal,402604,1889,404493,39.48,S244
2,DEEPAK,Samajwadi Party,366226,759,366985,35.82,S244
3,VIJENDER SINGH,Bahujan Samaj Party,218294,692,218986,21.38,S244
4,ABDUL BARI,Jai Samta Party,8046,26,8072,0.79,S244
5,DEEPAK KUMAR,Independent,7284,34,7318,0.71,S244
6,ZAHEER,Independent,2780,8,2788,0.27,S244
7,RAJAPAL,Peoples Party of India (Democratic),2361,12,2373,0.23,S244
8,MOHD. SHAHJAD,Independent,2342,5,2347,0.23,S244
9,FARMAN,Majloom Samaj Party,2334,9,2343,0.23,S244
10,CHANDAN SINGH,Independent,2132,44,2176,0.21,S244
11,RAMDHAN SINGH,Majdoor Kisan Union Party,2088,17,2105,0.21,S244
12,NOTA,None of the Above,4386,60,4446,0.43,S244
1,CHANDRA PRAKASH CHOUDHARY,AJSU Party,447896,3243,451139,35.67,S276
2,MATHURA PRASAD MAHATO,Jharkhand Mukti Morcha,367197,3062,370259,29.27,S276
3,JAIRAM KUMAR MAHATO,Independent,342241,5081,347322,27.46,S276
4,KAMAL PRASAD,Bahujan Samaj Party,13971,103,14074,1.11,S276
5,SUBODH KUMAR YADAV,Independent,13093,13,13106,1.04,S276
6,RAMESHWAR DUSADH,Independent,11011,9,11020,0.87,S276
7,SUNITA TUDU,Independent,10899,45,10944,0.87,S276
8,MD AINUL ANSARI,Bahujan Mukti Party,6919,20,6939,0.55,S276
9,DWARAKA PRASAD LALA,Independent,5617,10,5627,0.44,S276
10,KALAWATI DEVI,Independent,5414,16,5430,0.43,S276
11,GYANESHWAR PRASAD,Lokhit Adhikar Party,5348,8,5356,0.42,S276
12,SHIVJI PRASAD,Right to Recall Party,4248,6,4254,0.34,S276
13,PRAMOD RAM,Peoples Party of India (Democratic),3805,20,3825,0.3,S276
14,USHA SINGH,Independent,3703,58,3761,0.3,S276
15,PAPPU KUMAR NISHAD,Bhartiya Lokmat Rashtrwadi Party,3203,13,3216,0.25,S276
16,SUBHASH KUMAR THAKUR,Sarv Samaj Party,2513,4,2517,0.2,S276
17,NOTA,None of the Above,5927,117,6044,0.48,S276
1,RAJA A,Dravida Munnetra Kazhagam,470729,2483,473212,46.44,S2219
2,DR MURUGAN L,Bharatiya Janata Party,231111,1516,232627,22.83,S2219
3,LOGESH TAMILSELVAN D,All India Anna Dravida Munnetra Kazhagam,219417,813,220230,21.61,S2219
4,JAYAKUMAR A,Naam Tamilar Katchi,58588,233,58821,5.77,S2219
5,VIJAYAKUMAR D,Independent,4805,3,4808,0.47,S2219
6,GANESHAMOORTHI A,Bahujan Samaj Party,3015,18,3033,0.3,S2219
7,BADRAN M,Ganasangam Party of India,2406,19,2425,0.24,S2219
8,SELVAN N,Independent,2038,16,2054,0.2,S2219
9,DHANABAL R,Independent,1906,22,1928,0.19,S2219
10,JAYANTHI M,Ambedkarite Party of India,1539,17,1556,0.15,S2219
11,MURUGAN Y,Independent,1408,5,1413,0.14,S2219
12,MURUGESAN,Independent,1057,2,1059,0.1,S2219
13,MALARMANNAN M,Samaniya Makkal Nala Katchi,813,7,820,0.08,S2219
14,SATHISH M,Independent,734,6,740,0.07,S2219
15,KRISHNA KUMAR,Independent,588,27,615,0.06,S2219
16,ANBHUGURU V,Independent,560,5,565,0.06,S2219
17,NOTA,None of the Above,12902,98,13000,1.28,S2219
1,MOHITE-PATIL DHAIRYASHEEL RAJSINH,Nationalist Congress Party – Sharadchandra Pawar,618566,3647,622213,48.86,S1343
2,RANJEETSINGH HINDURAO NAIK NIMBALKAR,Bharatiya Janata Party,499171,2205,501376,39.37,S1343
3,ER. RAMCHANDRA MAYAPPA GHUTUKADE,New Rashtriya Samaj Party,58344,77,58421,4.59,S1343
4,BARASKAR RAMESH NAGNATH,Vanchit Bahujan  Aaghadi,20519,85,20604,1.62,S1343
5,JANKAR SWARUP DADA,Bahujan Samaj Party,7036,58,7094,0.56,S1343
6,HAKE LAXMAN SOPAN,Independent,5083,51,5134,0.4,S1343
7,SITARAM VITTHAL RANDIVE,Independent,4980,6,4986,0.39,S1343
8,DHANAJI SHRIPATI MASKE,Independent,4433,0,4433,0.35,S1343
9,BICHUKALE SANTOSH BALASAHEB,Republican Party of India (A),4039,7,4046,0.32,S1343
10,SAWANT RAHUL SHASHIKANT,Independent,3903,6,3909,0.31,S1343
11,AWARE SIDDHESHWAR BHARAT,All India Forward Bloc,3058,9,3067,0.24,S1343
12,HANUMANT NARAYAN MANE,Independent,2862,2,2864,0.22,S1343
13,NANDU SAMBHAJI MORE,Independent,2686,1,2687,0.21,S1343
14,NAVANATH BIRA MADANE,Independent,2434,1,2435,0.19,S1343
15,GIRISH PRABHAKAR SHETE,Independent,2380,3,2383,0.19,S1343
16,ADV. JORE SACHIN BHASKAR,Independent,2344,3,2347,0.18,S1343
17,NANASAHEB RAMHARI YADAV,Independent,2213,1,2214,0.17,S1343
18,KIRAN TANAJI SATHE,Independent,2167,8,2175,0.17,S1343
19,BHAUSAHEB SUKHADEV LIGADE,Independent,2034,18,2052,0.16,S1343
20,ER. BALIRAM SUKHADEV MORE,Independent,1952,1,1953,0.15,S1343
21,KHARAT SANDIP JANARADHAN,Independent,1746,9,1755,0.14,S1343
22,NARAYAN TATOBA KALEL,Independent,1557,3,1560,0.12,S1343
23,KASHINATH KISAN DEOKATE,Independent,1276,3,1279,0.1,S1343
24,GOPAL YESHVANT JADHAV,Bharatheeya Jawan Kisan Party,1273,16,1289,0.1,S1343
25,SATYAWAN VIJAY OMBASE,Swarajya Sena (Maharashtra),1254,6,1260,0.1,S1343
26,SITAPURE VINOD DILIP,Independent,1190,1,1191,0.09,S1343
27,ASHOK DNYANDEV WAGHMODE,Independent,984,5,989,0.08,S1343
28,ANIL BHAGAVAN SHEDAGE,Independent,977,5,982,0.08,S1343
29,AMOL MADHUKAR KARADE,Independent,900,3,903,0.07,S1343
30,RASHID ISMAIL SHAIKH,Independent,842,1,843,0.07,S1343
31,MORE ROHIT RAMKRUSHNA,Independent,669,2,671,0.05,S1343
32,SARADE GANESH NAVNATH,Independent,598,3,601,0.05,S1343
33,NOTA,None of the Above,3655,47,3702,0.29,S1343
1,BHARTRUHARI MAHTAB,Bharatiya Janata Party,529271,2330,531601,47.43,S1814
2,SANTRUPT MISRA,Biju Janata Dal,473443,1081,474524,42.34,S1814
3,SURESH MOHAPATRA,Indian National Congress,83461,354,83815,7.48,S1814
4,PRAMOD KUMAR MALLICK,Bahujan Samaj Party,4461,23,4484,0.4,S1814
5,NIRANJAN PATI,Independent,4390,6,4396,0.39,S1814
6,SOBHA PANDEY,Independent,3878,10,3888,0.35,S1814
7,PRAKASH CHANDRA SAHOO,Krupaa Party,3790,4,3794,0.34,S1814
8,RAJAKISHORE MALLIK,Socialist Unity Centre Of India (COMMUNIST),3072,3,3075,0.27,S1814
9,GOKULANANDA MISHRA,Independent,1804,4,1808,0.16,S1814
10,MINATI PATNAIK,Samruddha Odisha,1241,10,1251,0.11,S1814
11,NOTA,None of the Above,8130,29,8159,0.73,S1814
1,SANTOSH PANDEY,Bharatiya Janata Party,711439,618,712057,49.25,S266
2,BHUPESH BAGHEL,Indian National Congress,667078,568,667646,46.18,S266
3,A.H. SIDDIQUI,Independent,10737,0,10737,0.74,S266
4,DEVLAL SINHA (SONVANSHI),Bahujan Samaj Party,9659,9,9668,0.67,S266
5,NARAD PRASAD NISHAD,Shakti Sena (Bharat Desh),8029,1,8030,0.56,S266
6,SUKHDEV SINHA,Independent,7998,3,8001,0.55,S266
7,VISHESH DHAMGAYE,Independent,4872,1,4873,0.34,S266
8,BHUVAN SAHU,Independent,4171,3,4174,0.29,S266
9,LALITA KANWAR,Hamar Raj Party,2139,10,2149,0.15,S266
10,ER. BASANT KUMAR MESHRAM,Independent,1818,2,1820,0.13,S266
11,RAMESH RAJPUT,Bhartiya Shakti Chetna Party,1735,2,1737,0.12,S266
12,TRIVENI PADOTI,Independent,1607,6,1613,0.11,S266
13,RAMFAL PATIL,Nyaydharmsabha,1535,2,1537,0.11,S266
14,AJAY PALI,Independent,1114,0,1114,0.08,S266
15,LAKHAN SING TANDAN,Rashtriya Jansabha Party,1056,0,1056,0.07,S266
16,NOTA,None of the Above,9152,401,9553,0.66,S266
1,S SUPONGMEREN JAMIR,Indian National Congress,399512,2439,401951,52.83,S171
2,DR CHUMBEN MURRY,Nationalist Democratic Progressive Party,350072,895,350967,46.13,S171
3,HAYITHUNG TUNGOE LOTHA,Independent,6050,182,6232,0.82,S171
4,NOTA,None of the Above,1520,126,1646,0.22,S171
1,JADHAV PRATAPRAO GANPATRAO,Shiv Sena,348289,1578,349867,31.53,S135
2,NARENDRA DAGDU KHEDEKAR,Shiv Sena (Uddhav Balasaheb Thackrey),319415,973,320388,28.88,S135
3,RAVIKANT CHANDRADAS TUPKAR,Independent,249042,921,249963,22.53,S135
4,VASANTRAO RAJARAM MAGAR,Vanchit Bahujan  Aaghadi,98093,348,98441,8.87,S135
5,ASHOK WAMAN HIWALE,Independent,15414,22,15436,1.39,S135
6,SANDEEP RAMRAO SHELKE,Independent,12993,57,13050,1.18,S135
7,GAUTAM KISANRAO MAGHADE,Bahujan Samaj Party,8125,93,8218,0.74,S135
8,ASLAM SHAH HASAN SHAH,Maharashtra Vikas Aghadi,6117,36,6153,0.55,S135
9,NANDU JAGANNATH LAWANGE,Independent,5696,17,5713,0.51,S135
10,MACHHINDRA SHESHRAV MAGHADE,Socialist Party (India),5247,11,5258,0.47,S135
11,MOHAMMAD HASAN INAMDAR,Minorities Democratic Party,4966,12,4978,0.45,S135
12,GAJANAN JANARDAN DHANDE,Independent,4841,13,4854,0.44,S135
13,DINKAR TUKARAM SAMBARE,Independent,4550,14,4564,0.41,S135
14,BALASAHEB RAMCHANDRA INGLE,Independent,3911,20,3931,0.35,S135
15,PRATAP PANDHARINATH PATIL,Independent,2547,14,2561,0.23,S135
16,SANTOSH BHIMRAO INGLE,Republican Party of India (A),2524,6,2530,0.23,S135
17,MADHAVRAO SAKHARAM BANSODE,Bahujan Republican  Socialist Party,2441,14,2455,0.22,S135
18,VIKAS BHAI NANDAVE,Bhim Sena,2322,9,2331,0.21,S135
19,UDDHAV ONKAR ATOLE,Independent,1946,22,1968,0.18,S135
20,REKHA KAILAS POPHALKAR,Independent,1533,7,1540,0.14,S135
21,PROF SUMANTAI TIRPUDE,Peoples Party of India (Democratic),1505,6,1511,0.14,S135
22,NOTA,None of the Above,3750,36,3786,0.34,S135
1,GADDIGOUDAR. PARVATAGOUDA. CHANDANAGOUDA.,Bharatiya Janata Party,667441,3598,671039,50.93,S103
2,SAMYUKTA SHIVANAND PATIL,Indian National Congress,600741,1899,602640,45.74,S103
3,NAGARAJ. S. KALKUTAGAR,Independent,5628,1,5629,0.43,S103
4,PARASHURAM. LAXMAN. NEELANAIK,Independent,5084,6,5090,0.39,S103
5,ANTHOSH SAVVASE,Uttama Prajaakeeya Party,4909,14,4923,0.37,S103
6,JYOTI GULEDGUDDA,Independent,4636,9,4645,0.35,S103
7,M. B. SIDAGONI,Bahujan Samaj Party,4453,26,4479,0.34,S103
8,DR. MUTTU. S. SURAKOD. (MADAR),Independent,3131,4,3135,0.24,S103
9,PRASHANT RAO,Independent,1909,5,1914,0.15,S103
10,DATTATREYA DASHARATHA TAVARE,Independent,1607,13,1620,0.12,S103
11,AMBROSE D' MELLO,Independent,1203,2,1205,0.09,S103
12,KENGANAL. MALLIKARJUN. BHIMAPPA,Independent,1189,18,1207,0.09,S103
13,MALLIKARJUN H. T.,Socialist Unity Centre Of India (COMMUNIST),1137,7,1144,0.09,S103
14,RAJESAB BURANSAB. MASALI,Independent,988,4,992,0.08,S103
15,SHARANAPPA MALLAPPA KOTLANNAVAR,Independent,830,2,832,0.06,S103
16,RAVI SHIVAPPA PADASALAGI,Independent,654,2,656,0.05,S103
17,SAIYYAD IMAMSAB JAKALI,Tipu Sultan Party,546,4,550,0.04,S103
18,ABDULAZIZ KALADAGI PENDARI,Independent,524,5,529,0.04,S103
19,MUTTAPPA MUDAKAPPA HIREKUMBI,Raita Bharat Party,509,9,518,0.04,S103
20,SAGAR. BASAPPA. KUMBAR,Karnataka Rashtra Samithi,494,5,499,0.04,S103
21,S. M. MARIGOUDAR,Desh Prem Party,451,3,454,0.03,S103
22,SHANKAR. VENKAPPA. NAIKAR.,Republican Party of India (A),431,10,441,0.03,S103
23,NOTA,None of the Above,3398,22,3420,0.26,S103
1,SHRIMANT CHH UDAYANRAJE PRATAPSINHAMAHARAJ BHONSLE,Bharatiya Janata Party,568749,2385,571134,47.67,S1345
2,SHASHIKANT JAYVANTRAO SHINDE,Nationalist Congress Party – Sharadchandra Pawar,536475,1888,538363,44.94,S1345
3,GADE SANJAY KONDIBA,Independent,37035,27,37062,3.09,S1345
4,KADAM PRASHANT RAGHUNATH,Vanchit Bahujan  Aaghadi,11878,34,11912,0.99,S1345
5,ANAND RAMESH THORWADE,Bahujan Samaj Party,6432,53,6485,0.54,S1345
6,KORDE SURESHRAO DINKAR,Independent,4699,13,4712,0.39,S1345
7,MARUTI DHONDIRAM JANKAR,Independent,3944,7,3951,0.33,S1345
8,SEEMA SUNIL POTDAR,Independent,3458,0,3458,0.29,S1345
9,VISHWAJIT PATIL UNDALKAR,Independent,3432,6,3438,0.29,S1345
10,NIVRUTTI KERU SHINDE,Independent,2666,8,2674,0.22,S1345
11,SAYAJI GANPAT WAGHMARE,Bahujan Republican  Socialist Party,2490,11,2501,0.21,S1345
12,SACHIN SUBHASH MAHAJAN,Independent,2010,5,2015,0.17,S1345
13,DR ABHIJEET WAMANRAO AWADE BICHUKALE,Independent,1388,7,1395,0.12,S1345
14,TUSHAR VIJAY MOTLING,Bahujan Mukti Party,1296,5,1301,0.11,S1345
15,PRATIBHA SHELAR,Independent,1104,19,1123,0.09,S1345
16,BAGAL SADASHIV SAHEBRAO,Independent,955,3,958,0.08,S1345
17,NOTA,None of the Above,5476,46,5522,0.46,S1345
1,SMITA UDAY WAGH,Bharatiya Janata Party,672119,2309,674428,57.67,S133
2,KARAN BALASAHEB PATIL - PAWAR,Shiv Sena (Uddhav Balasaheb Thackrey),421213,1621,422834,36.15,S133
3,YUVRAJ JADHAV (SAMBHA AAPPA),Vanchit Bahujan  Aaghadi,21062,115,21177,1.81,S133
4,EX-HAVILDAR ISHWAR DAYARAM MORE,Sainik Samaj Party,7479,69,7548,0.65,S133
5,VILAS SHANKAR TAYADE,Bahujan Samaj Party,6310,71,6381,0.55,S133
6,LALIT (BANTI) SHARMA,Independent,4189,3,4192,0.36,S133
7,KARAN PAWAR,Independent,3954,29,3983,0.34,S133
8,ADVOCATE VIJAY BABULAL DANEJ,Independent,3400,4,3404,0.29,S133
9,MUKESH MULCHAND KOLI,Independent,3358,12,3370,0.29,S133
10,MAHENDRA DEVRAM KOLI,Independent,2462,14,2476,0.21,S133
11,AHMAD KHAN,Independent,1889,12,1901,0.16,S133
12,ABDUL SHAKUR DESHPANDE,Independent,1593,13,1606,0.14,S133
13,ADV. NAMDEO PANDURANG KOLI,Independent,1212,12,1224,0.1,S133
14,PATIL SANDIP YUVRAJ,Independent,1098,12,1110,0.09,S133
15,NOTA,None of the Above,13878,41,13919,1.19,S133
1,T.SUMATHY (ALIAS) THAMIZHACHI THANGAPANDIAN,Dravida Munnetra Kazhagam,515307,1321,516628,47,S223
2,DR.TAMILISAI SOUNDARARAJAN,Bharatiya Janata Party,289229,1454,290683,26.44,S223
3,DR.J.JAYAVARDHAN,All India Anna Dravida Munnetra Kazhagam,172108,383,172491,15.69,S223
4,S.TAMILCHELVI,Naam Tamilar Katchi,83821,151,83972,7.64,S223
5,M.G.RAMU,Jebamani Janata,3526,8,3534,0.32,S223
6,M.AZARUTHEEN,Independent,1808,4,1812,0.16,S223
7,G.P. ROBERT,Bahujan Samaj Party,1596,3,1599,0.15,S223
8,R.RAVICHANDRAN,Independent,835,0,835,0.08,S223
9,S.MANIMARAN,Independent,803,0,803,0.07,S223
10,FARMER JAYARAMAN. S.K.J,Desiya Makkal Sakthi Katchi,790,2,792,0.07,S223
11,A.K.D. ELLAPPAN,Mahathma Makkal Munnetra Kazhakam,761,0,761,0.07,S223
12,K.KANNAN,Independent,625,0,625,0.06,S223
13,BALAJI. G. MANGADU,Aravor Munnetra Kazhagam,588,1,589,0.05,S223
14,KUTTIMANI. S,Veerath Thiyagi Viswanathadoss Thozhilalarkal Katchi,565,0,565,0.05,S223
15,R.KANCHANA,Tamizhaga Murpokku Makkal Katchi,565,1,566,0.05,S223
16,SASI REKHA,Naadaalum Makkal Katchi,557,2,559,0.05,S223
17,P. SATHEESH KUMAR,Independent,520,1,521,0.05,S223
18,P.SEKAR,Thakkam Katchi,435,0,435,0.04,S223
19,R.YOGESHWARAN,Independent,425,1,426,0.04,S223
20,J. SATHISH,Independent,418,0,418,0.04,S223
21,V.P. RAVIKKARAN,Independent,372,1,373,0.03,S223
22,A.PONNUDURAI,Independent,362,0,362,0.03,S223
23,N.V.DAMODARAN,National Maha Sabha Party,341,2,343,0.03,S223
24,M.MUNUSWAMY,Viro Ke Vir Indian Party,326,4,330,0.03,S223
25,KARTHIK MURTHY,Independent,312,3,315,0.03,S223
26,V.P.SURESH,Independent,288,1,289,0.03,S223
27,E.RAMESH,Independent,270,0,270,0.02,S223
28,R.BALAJI,Independent,264,0,264,0.02,S223
29,DINESH KUMAR. B,Independent,253,0,253,0.02,S223
30,A.BABU,Independent,246,0,246,0.02,S223
31,DAYALAN. R,Independent,241,1,242,0.02,S223
32,VIJIRATHINAM. M,Independent,237,0,237,0.02,S223
33,V.SIVAKUMAR,Independent,217,0,217,0.02,S223
34,MURUGAN. P,Independent,182,0,182,0.02,S223
35,G.RAMESHBABU,Independent,178,1,179,0.02,S223
36,S.RAJASEKARAN,Independent,177,1,178,0.02,S223
37,N.NARAYANASWAMY,Independent,175,0,175,0.02,S223
38,R.DEVENDRAN,Independent,167,1,168,0.02,S223
39,PARTHIBAN. S,Independent,165,1,166,0.02,S223
40,I. DAVIDSINGH,Independent,150,1,151,0.01,S223
41,E RAVENDRAN,Independent,114,0,114,0.01,S223
42,NOTA,None of the Above,15607,46,15653,1.42,S223
1,YADUVEER KRISHNADATTA CHAMARAJA WADIYAR,Bharatiya Janata Party,790391,5112,795503,53.59,S1021
2,M. LAKSHMANA,Indian National Congress,653739,2502,656241,44.21,S1021
3,RANGASWAMY. M,Independent,4301,5,4306,0.29,S1021
4,KADAMBA NAA AMBARISH,Karnataka Jantha Paksha,4069,11,4080,0.27,S1021
5,A. S. SATHISH,Independent,3736,10,3746,0.25,S1021
6,RAMAMURTHY. M,Independent,3601,4,3605,0.24,S1021
7,RAJU,Independent,1940,9,1949,0.13,S1021
8,PRAJAKEEYA LEELA SHIVAKUMAR,Uttama Prajaakeeya Party,1724,30,1754,0.12,S1021
9,COMRADE SUNIL T. R,Socialist Unity Centre Of India (COMMUNIST),1538,22,1560,0.11,S1021
10,H. K. KRISHNA,Karunaadu Party,1479,10,1489,0.1,S1021
11,HARISH GOWDA,Socialist Party (India),967,9,976,0.07,S1021
12,P. S. YADURAPPA,Independent,874,4,878,0.06,S1021
13,AMBEDKAR. C. J,Independent,821,14,835,0.06,S1021
14,DARSHAN K PONNETI,Independent,761,3,764,0.05,S1021
15,M. S. PRAVEEN,Karnataka Rashtra Samithi,735,5,740,0.05,S1021
16,CHRISTOPHER RAJ KUMAR,Independent,533,11,544,0.04,S1021
17,DR. H. M. NANJUNDASWAMY,Samajwadi Janata Party(Karnataka),519,4,523,0.04,S1021
18,A. G. RAMACHANDRA RAO,Secular Democratic Congress,487,3,490,0.03,S1021
19,NOTA,None of the Above,4446,44,4490,0.3,S1021
1,MURLIDHAR MOHOL,Bharatiya Janata Party,584171,557,584728,52.94,S1334
2,DHANGEKAR RAVINDRA HEMRAJ,Indian National Congress,461409,281,461690,41.8,S1334
3,VASANT (TATYA) MORE,Vanchit Bahujan  Aaghadi,31991,21,32012,2.9,S1334
4,RANPISE PRASHANT DADARAM,Bahujan Samaj Party,3969,5,3974,0.36,S1334
5,CHORMALE SANDIP SOPAN,Independent,1644,1,1645,0.15,S1334
6,GORAKH NARAYAN GHODKE,Independent,1451,0,1451,0.13,S1334
7,KIRAN LAXMAN RAYKAR,Independent,1052,0,1052,0.1,S1334
8,ANIS ARASHID SUNDAKE,All India Majlis-E-Ittehadul Muslimeen,859,1,860,0.08,S1334
9,SACHIN DATTATRAY DHANKUDE,Independent,788,1,789,0.07,S1334
10,YUVRAJ CHANDRAKANT  LIMBOLE,Right to Recall Party,698,0,698,0.06,S1334
11,DR. DEVYANI PANDIT,Independent,645,5,650,0.06,S1334
12,NARENDRA DNYANESHWAR PAWTEKAR,Independent,533,1,534,0.05,S1334
13,SAGAR SAMBHAJI PORE,Independent,515,0,515,0.05,S1334
14,SURESH DNYANOBA PATIL,Sainik Samaj Party,437,0,437,0.04,S1334
15,AMBORE MANJUNATH MARUTI,Independent,433,0,433,0.04,S1334
16,ASHWINI PRATIBHA KHAIRNAR,Independent,412,3,415,0.04,S1334
17,VIJAY VINAYAK JAGTAP,Independent,382,0,382,0.03,S1334
18,HEMANT BABURAV KOLEKAR ALIAS HEMANT PATIL,Apni Prajahit Party,374,1,375,0.03,S1334
19,NEERAJ SUNIL KAMTHAN,Hindu Samaj Party,351,0,351,0.03,S1334
20,MANOJ LAXMAN VETAL,Bhim Sena,351,1,352,0.03,S1334
21,KAMBLE MILIND,Bahujan Samaj Party  (Ambedkar),344,3,347,0.03,S1334
22,CHANDRAKANT PARMESHWAR SAWANT,Independent,314,0,314,0.03,S1334
23,SHABBIR SAJJANBHAI TAMBOLI,Independent,313,0,313,0.03,S1334
24,SANJAY LAXMAN KENDALE,Independent,311,0,311,0.03,S1334
25,JOHNSON VASANT KOLHAPURE,Independent,304,1,305,0.03,S1334
26,ADV. YOGESH MAKANE,Independent,298,1,299,0.03,S1334
27,SUBROTO ROY,Ekam Sanatan Bharat Dal,293,1,294,0.03,S1334
28,DR. BALASAHEB ARJUN POL,Independent,259,0,259,0.02,S1334
29,VIJAYALAXMI SHRIKANT SINDAGI,Rashtriya Maratha Party,239,1,240,0.02,S1334
30,MAHESH DASHRATH MHASKE,Independent,229,2,231,0.02,S1334
31,YABES ALIAS AMOL SHAMUVEL TUJARE,Independent,223,0,223,0.02,S1334
32,VIJAY PANDURANGRAO DESHMUKH (DABADGAONKAR),Independent,183,2,185,0.02,S1334
33,BABA SALIM SAYYED,Independent,163,1,164,0.01,S1334
34,BAGBAN SALEEM ABDUL RAZZAQUE,Independent,146,0,146,0.01,S1334
35,ZNYOSHO VIJAYPRAKASH,Independent,138,0,138,0.01,S1334
36,NOTA,None of the Above,7449,11,7460,0.68,S1334
1,SUKANTA MAJUMDAR,Bharatiya Janata Party,572925,2071,574996,46.47,S256
2,BIPLAB MITRA,All India Trinamool Congress,563252,1358,564610,45.63,S256
3,JOYDEV KUMAR SIDDHANTA,Revolutionary Socialist Party,54081,136,54217,4.38,S256
4,HAKIM MURMU,Independent,6820,2,6822,0.55,S256
5,BAKHTIAR MUJAHIT SAHANI,Independent,6391,2,6393,0.52,S256
6,RANENDRA NATH MALI,Independent,5590,3,5593,0.45,S256
7,ANTA HANSDA,Bahujan Samaj Party,5130,15,5145,0.42,S256
8,BISWANATH MURMU,Ambedkarite Party of India,3454,11,3465,0.28,S256
9,MOZAMMEL HAQUE,All India Secular Front,2261,7,2268,0.18,S256
10,NAROTTAM SAHA,Independent,2095,11,2106,0.17,S256
11,MD. SARWARDI,Bhumiputra United Party,1957,10,1967,0.16,S256
12,BIRENDRA NATH MAHANTA,Socialist Unity Centre Of India (COMMUNIST),1380,7,1387,0.11,S256
13,RUBEL SARKAR,Kamatapur People’s Party (United),898,4,902,0.07,S256
14,NOTA,None of the Above,7430,7,7437,0.6,S256
1,BHARAT SINGH KUSHWAH,Bharatiya Janata Party,668782,2753,671535,49.99,S123
2,PRAVEEN PATHAK,Indian National Congress,599077,2248,601325,44.77,S123
3,KALYAN SINGH KANSANA,Bahujan Samaj Party,33308,157,33465,2.49,S123
4,ARCHANA SINGH RATHORE,Rashtriya Samaj Paksha,5873,19,5892,0.44,S123
5,BHARAT PAL,Aazad Samaj Party (Kanshi Ram),4138,25,4163,0.31,S123
6,ER. MAHENDRA PRATAP SINGH PAL,Independent,3777,6,3783,0.28,S123
7,RAKESH DHAKAD,Independent,3218,2,3220,0.24,S123
8,YASHDEV SHARMA,Independent,2568,3,2571,0.19,S123
9,DEEPAK KUMAR BANSAL (RANG WALE),Independent,2448,0,2448,0.18,S123
10,SHREE NARESH CHANDRA SHARMA,Independent,2215,1,2216,0.16,S123
11,GAJENDRA SINGH,Independent,1343,5,1348,0.1,S123
12,ANJALI MONU RAWAT,Parivartan Party of India,1272,7,1279,0.1,S123
13,ADVOCATE MUKESH KUMAR KORI,Independent,1130,4,1134,0.08,S123
14,RAM PRAKASH SINGH PAL,Rashtra Uday Party,1059,12,1071,0.08,S123
15,CHANDAN RATHORE,Parivartan Samaj Party,1053,6,1059,0.08,S123
16,DR. P. D. AGARWAL SR. MEDICAL CONSULTANT,Independent,1016,5,1021,0.08,S123
17,AMIT PARIHAR,Independent,877,6,883,0.07,S123
18,COMRADE RACHNA AGRAWAL,Socialist Unity Centre Of India (COMMUNIST),798,5,803,0.06,S123
19,MUNESH NAGAR,Vikas India Party,667,5,672,0.05,S123
20,NOTA,None of the Above,3309,32,3341,0.25,S123
1,MUKESH RAJPUT,Bharatiya Janata Party,486925,1038,487963,47.2,S2440
2,DR. NAVAL KISHOR SHAKYA,Samajwadi Party,484485,800,485285,46.94,S2440
3,KRANTI PANDEY,Bahujan Samaj Party,45274,116,45390,4.39,S2440
4,AMAR SINGH,Bharatiya Rashtriya Morcha,3345,13,3358,0.32,S2440
5,HARNANDAN SINGH,Independent,2457,12,2469,0.24,S2440
6,SHYAMVEER SINGH,Bharatiya Nagrik Party,2431,3,2434,0.24,S2440
7,VIDYAPRAKASH,Bharatheeya Jawan Kisan Party,1456,11,1467,0.14,S2440
8,DINESH,Bhartiya Shakti Chetna Party,1061,2,1063,0.1,S2440
9,NOTA,None of the Above,4350,15,4365,0.42,S2440
1,JASWANTSINH SUMANBHAI BHABHOR,Bharatiya Janata Party,685734,2981,688715,61.59,S0619
2,DR. PRABHABEN KISHORSINH TAVIYAD,Indian National Congress,352238,2800,355038,31.75,S0619
3,MEDA DEVENDRAKUMAR LAXMANBHAI,Independent,11068,7,11075,0.99,S0619
4,BHABHOR DHULABHAI DITABHAI,Bahujan Samaj Party,8621,11,8632,0.77,S0619
5,BARIYA MANILAL HIRABHAI,Independent,6576,12,6588,0.59,S0619
6,DAMOR VESTABHAI JOKHANABHAI,Independent,4374,26,4400,0.39,S0619
7,DAMOR MANABHAI BHAVSINGBHAI,Independent,3144,29,3173,0.28,S0619
8,JAGDISHBHAI MANILAL MEDA,Bharatiya National Janata Dal,3053,9,3062,0.27,S0619
9,PASAYA NAVALSINH MULABHAI,Saath Sahakar Vikas Party,2667,6,2673,0.24,S0619
10,NOTA,None of the Above,34774,164,34938,3.12,S0619
1,RAHUL GANDHI,Indian National Congress,686044,1605,687649,66.17,S2436
2,DINESH PRATAP SINGH,Bharatiya Janata Party,296703,916,297619,28.64,S2436
3,THAKUR PRASAD YADAV,Bahujan Samaj Party,21588,36,21624,2.08,S2436
4,DILEEP SINGH,Akhil Bhartiya Apna Dal,8676,2,8678,0.84,S2436
5,HORILAL,Independent,5397,2,5399,0.52,S2436
6,SUDARSHAN RAM,Bhartiya Panchsheel Party,4343,2,4345,0.42,S2436
7,HIND ROHITASH,Manavtawadi Samaj Party,3859,0,3859,0.37,S2436
8,MO MOBIN,Apna Dal (Kamerawadi),2173,1,2174,0.21,S2436
9,NOTA,None of the Above,7861,11,7872,0.76,S2436
1,PANKAJ CHAUDHARY,Bharatiya Janata Party,590487,823,591310,48.85,S2463
2,VIRENDRA CHAUDHARY,Indian National Congress,555045,814,555859,45.92,S2463
3,MO MAUSME ALAM,Bahujan Samaj Party,32893,62,32955,2.72,S2463
4,BRIJESH,Abhay Samaj Party,8575,8,8583,0.71,S2463
5,CHHEDI MAJDOOR,Independent,3833,1,3834,0.32,S2463
6,RAMPRIT,Independent,3028,1,3029,0.25,S2463
7,SUNIL,Independent,2716,2,2718,0.22,S2463
8,VINOD KUMAR PATEL,Sardar Patel Siddhant Party,2415,3,2418,0.2,S2463
9,NOTA,None of the Above,9730,15,9745,0.81,S2463
1,ALOK SHARMA,Bharatiya Janata Party,978285,2824,981109,65.48,S1219
2,ADVOCATE ARUN SHRIVASTAVA,Indian National Congress,478698,912,479610,32.01,S1219
3,BHANU PRATAP SINGH,Bahujan Samaj Party,13255,50,13305,0.89,S1219
4,DEENDAYAL AHIRWAR URF DEENU BHAIYA,Independent,3639,2,3641,0.24,S1219
5,JAY SINGH,Independent,2509,1,2510,0.17,S1219
6,BHARTI YADAV,Independent,1833,6,1839,0.12,S1219
7,ANKIT RAI,Independent,1100,1,1101,0.07,S1219
8,DHANRAJ SHENDE,Republican Party of India (A),788,2,790,0.05,S1219
9,AJAY KUMAR PATHAK,Chhatrapati Shivaji Bhartiya Garib Party,787,3,790,0.05,S1219
10,MOHAMMAD ASHRAF,Independent,777,1,778,0.05,S1219
11,BABULAL SEN,Moulik Adhikar Party,718,2,720,0.05,S1219
12,SANJAY KUMAR SAROJ,Manav Samadhan Party,621,1,622,0.04,S1219
13,BALRAM SINGH TAUMAR,Bhartiya Shakti Chetna Party,587,1,588,0.04,S1219
14,RAMPRASAD PATEL,Kranti Janshakti Party,572,3,575,0.04,S1219
15,MUDIT CHAURASIA,Akhil Bhartiya Aarakshit Samaj Party,541,3,544,0.04,S1219
16,MUDIT BHATNAGAR,Socialist Unity Centre Of India (COMMUNIST),537,3,540,0.04,S1219
17,R.K. MAHAJAN,Independent,527,2,529,0.04,S1219
18,ABDUL TAHIR ADVOCATE (BABLU RAJNIKANT)  S/O SAEED PAHELWAN ANSARI,Bahujan Maha Party,473,0,473,0.03,S1219
19,MAITHILI SHARAN GUPTA,Independent,447,1,448,0.03,S1219
20,RAJESH KEER,Independent,427,0,427,0.03,S1219
21,AKSHAY GOTHI,Parivartan Party of India,403,4,407,0.03,S1219
22,HITENDRA SHAHARE (BABA),Independent,318,0,318,0.02,S1219
23,NOTA,None of the Above,6573,48,6621,0.44,S1219
1,DEEPENDER SINGH HOODA,Indian National Congress,778259,5319,783578,62.76,S077
2,DR. ARVIND KUMAR SHARMA,Bharatiya Janata Party,435028,3252,438280,35.11,S077
3,RAVINDER,Jannayak Janta Party,6209,41,6250,0.5,S077
4,RAKESH SINGH,Rashtrawadi Janlok Party (Satya),2706,8,2714,0.22,S077
5,BISHAMBAR KUMAR,Independent,2394,0,2394,0.19,S077
6,KALAWATI,Independent,2135,15,2150,0.17,S077
7,PARVEEN KUMAR,Independent,1927,1,1928,0.15,S077
8,UDEVIR,Independent,1530,2,1532,0.12,S077
9,VINOD KUMAR,Peoples Party of India (Democratic),805,4,809,0.06,S077
10,ASHOK KUMAR,Independent,627,2,629,0.05,S077
11,VISHESH BAMEL,Bharatiya Asha Party,613,5,618,0.05,S077
12,JAIKARAN MANDAUTHI,Socialist Unity Centre Of India (COMMUNIST),600,7,607,0.05,S077
13,JAGBIR SINGH,Bharatheeya Jawan Kisan Party,574,19,593,0.05,S077
14,SATISH KUMAR,Independent,524,0,524,0.04,S077
15,SURENDER,Aam Aadmi Parivartan Party,447,23,470,0.04,S077
16,MANISHA,Independent,410,21,431,0.03,S077
17,ARVIND KUMAR SHARMA,Independent,360,7,367,0.03,S077
18,SATISH KUMAR,Ekam Sanatan Bharat Dal,359,4,363,0.03,S077
19,ARVIND,Independent,330,0,330,0.03,S077
20,ADVOCATE ADITYA DHANKHAR,Super Power India Party,275,12,287,0.02,S077
21,MASTER RANDHIR SINGH,Independent,267,2,269,0.02,S077
22,MANJEET,Independent,267,2,269,0.02,S077
23,SANJAY,Independent,210,2,212,0.02,S077
24,YOGESH SHARMA,Independent,190,0,190,0.02,S077
25,VINAY,Independent,156,3,159,0.01,S077
26,LALIT KUMAR,Independent,129,2,131,0.01,S077
27,NOTA,None of the Above,2321,41,2362,0.19,S077
1,AMAR SINGH,Indian National Congress,331324,1267,332591,34.14,S198
2,GURPREET SINGH GP,Aam Aadmi Party,297439,950,298389,30.63,S198
3,GEJJA RAM,Bharatiya Janata Party,127139,382,127521,13.09,S198
4,BIKRAMJIT SINGH KHALSA,Shiromani Akali Dal,126461,269,126730,13.01,S198
5,RAJ JATINDER SINGH,Shiromani Akali Dal (Amritsar)(Simranjit Singh Mann),43543,101,43644,4.48,S198
6,KULWANT SINGH,Bahujan Samaj Party,20786,106,20892,2.14,S198
7,PREM SINGH MOHANPUR,Independent,3784,8,3792,0.39,S198
8,BAHAL SINGH,Aazad Samaj Party (Kanshi Ram),3097,7,3104,0.32,S198
9,PARAMJIT SINGH,Independent,2159,8,2167,0.22,S198
10,RULDA SINGH,Independent,1971,6,1977,0.2,S198
11,PARKASH PETER,Independent,1463,2,1465,0.15,S198
12,HARJINDER SINGH,Independent,1158,8,1166,0.12,S198
13,KAMALJEET KAUR,Independent,888,11,899,0.09,S198
14,HARGOBIND SINGH,Independent,722,9,731,0.08,S198
15,NOTA,None of the Above,9097,91,9188,0.94,S198
1,DIMPLE YADAV,Samajwadi Party,596710,1816,598526,56.79,S2421
2,JAYVEER SINGH,Bharatiya Janata Party,375895,992,376887,35.76,S2421
3,SHIV PRASAD YADAV,Bahujan Samaj Party,66697,117,66814,6.34,S2421
4,SURESH CHANDRA,Independent,2366,8,2374,0.23,S2421
5,NAND RAM BAGRI,Voters Party  International,1765,4,1769,0.17,S2421
6,MANJU PAL,Bhartiya Shakti Chetna Party,1148,23,1171,0.11,S2421
7,PRAMOD KUMAR,Independent,994,12,1006,0.1,S2421
8,SUNIL KUMAR MISHRA,Sarva Samaj Janata Party,878,4,882,0.08,S2421
9,NOTA,None of the Above,4570,12,4582,0.43,S2421
1,SELVAM. G,Dravida Munnetra Kazhagam,582978,3066,586044,46.53,S226
2,RAJASEKAR. E,All India Anna Dravida Munnetra Kazhagam,362991,1580,364571,28.94,S226
3,JOTHI. V,Pattali Makkal Katchi,163792,1139,164931,13.09,S226
4,SANTHOSH KUMAR. V,Naam Tamilar Katchi,109858,414,110272,8.75,S226
5,ILAYARAJA. S,Bahujan Samaj Party,5243,21,5264,0.42,S226
6,VENKATESAN. K,Independent,2798,9,2807,0.22,S226
7,NARESH BHARATHI. S,Independent,2499,12,2511,0.2,S226
8,ELANGOVAN. M,Independent,1874,7,1881,0.15,S226
9,SURYA. A,Independent,1673,29,1702,0.14,S226
10,RAMESH. S,Independent,1317,1,1318,0.1,S226
11,SELVAM. T,Independent,1295,17,1312,0.1,S226
12,NOTA,None of the Above,16811,154,16965,1.35,S226
1,BIDYUT BARAN MAHATO,Bharatiya Janata Party,719891,6283,726174,56.84,S279
2,SAMIR KUMAR MOHANTY,Jharkhand Mukti Morcha,459997,6395,466392,36.5,S279
3,INDRA DEO PRASAD,Independent,8463,6,8469,0.66,S279
4,ARUN MAHATO,Independent,7337,7,7344,0.57,S279
5,ANAND MUKHI,Independent,6346,6,6352,0.5,S279
6,PRANAV KUMAR MAHTO,Bahujan Samaj Party,6090,61,6151,0.48,S279
7,BISHWANATH MAHATO,Independent,5226,105,5331,0.42,S279
8,ANGAD MAHATO,Amra Bangalee,4898,27,4925,0.39,S279
9,JUJHAR SOREN,Independent,4262,53,4315,0.34,S279
10,SUKUMAR SOREN,Bharat Adivasi Party,3860,34,3894,0.3,S279
11,DHARMU TUDU,Ambedkarite Party of India,3274,17,3291,0.26,S279
12,JITENDRA SINGH,Independent,3159,8,3167,0.25,S279
13,SANAKA MAHATO,Socialist Unity Centre Of India (COMMUNIST),3137,38,3175,0.25,S279
14,MANOJ GUPTA,Lokhit Adhikar Party,2355,7,2362,0.18,S279
15,SADHU CHARAN PAUL,Independent,2291,26,2317,0.18,S279
16,SAURAV VISHNU,Independent,2234,30,2264,0.18,S279
17,SHAIKH AKHIRUDDIN,Bahujan Maha Party,2099,9,2108,0.16,S279
18,ASHOK KUMAR,Peoples Party of India (Democratic),2038,10,2048,0.16,S279
19,MAHESH KUMAR,Right to Recall Party,1952,8,1960,0.15,S279
20,G JAYRAM DAS,Independent,1927,4,1931,0.15,S279
21,ARUN KUMAR SHARMA,Bhartiya Azad Sena,1797,4,1801,0.14,S279
22,DOMAN CHANDRA BHAKAT,Bhagidari Party(P),1343,5,1348,0.11,S279
23,BABLU PRASAD DANGI,Independent,1144,8,1152,0.09,S279
24,GYAN SAGAR PRASAD,Independent,1043,1,1044,0.08,S279
25,PARWATI KISKU,Independent,972,16,988,0.08,S279
26,NOTA,None of the Above,7105,221,7326,0.57,S279
1,PRAVEEN PATEL,Bharatiya Janata Party,451380,1220,452600,44.6,S2451
2,AMAR NATH SINGH MAURYA,Samajwadi Party,446596,1672,448268,44.17,S2451
3,JAGANNATH PAL,Bahujan Samaj Party,82375,211,82586,8.14,S2451
4,MAHIMA PATEL,Apna Dal (Kamerawadi),4134,28,4162,0.41,S2451
5,JILA JEET BHARTIY,Bahujan Awam Party,3294,5,3299,0.33,S2451
6,SUNIL KUMAR PRAJAPATI,Bhagidari Party(P),3040,7,3047,0.3,S2451
7,ENGG YOGESH KUSHWAHA,Pragatisheel Samaj Party,2768,3,2771,0.27,S2451
8,AKHILESH TRIPATHI,Independent,2295,3,2298,0.23,S2451
9,NAFIS AHAMAD,Independent,2145,2,2147,0.21,S2451
10,DR NEERAJ,Independent,1702,8,1710,0.17,S2451
11,SANJEEV KUMAR MISHRA,Yuva Vikas Party,1675,4,1679,0.17,S2451
12,MUSHIR AHMAD SIDDIQUI,Peoples Party of India (Democratic),1505,1,1506,0.15,S2451
13,SANGEETA YADAV,Subhashwadi Bhartiya Samajwadi Party (Subhas Party),1283,8,1291,0.13,S2451
14,LALA RAM SAROJ,Prabuddhwadi Bahujan Morcha,1043,9,1052,0.1,S2451
15,PRAMOD BHAI PATEL URF P K,Sardar Patel Siddhant Party,947,1,948,0.09,S2451
16,NOTA,None of the Above,5445,15,5460,0.54,S2451
1,IMRAN MASOOD,Indian National Congress,547383,584,547967,44.57,S241
2,RAGHAV LAKHANPAL,Bharatiya Janata Party,482120,1305,483425,39.32,S241
3,MAJID ALI,Bahujan Samaj Party,179994,359,180353,14.67,S241
4,MOHD INAM,Akhil Bhartiya Parivar Party,5392,8,5400,0.44,S241
5,SHABNAM,Independent,2370,3,2373,0.19,S241
6,SHAHBAJ,Independent,1696,2,1698,0.14,S241
7,RASHID KHAN,Independent,1227,3,1230,0.1,S241
8,TASMEEM BANO,Independent,883,2,885,0.07,S241
9,RAJKUMAR,Independent,807,6,813,0.07,S241
10,KAMRAN,Independent,744,1,745,0.06,S241
11,NOTA,None of the Above,4559,7,4566,0.37,S241
1,DHANORKAR PRATIBHA SURESH ALIAS BALUBHAU,Indian National Congress,716635,1775,718410,57.88,S1313
2,MUNGANTIWAR SUDHIR SACCHIDANAND,Bharatiya Janata Party,456943,1061,458004,36.9,S1313
3,BELE RAJESH WARLUJI,Vanchit Bahujan  Aaghadi,21934,46,21980,1.77,S1313
4,RAJENDRA HARISHCHANDRA RAMTEKE,Bahujan Samaj Party,9145,43,9188,0.74,S1313
5,SANJAY NILKANTH GAWANDE,Independent,5087,1,5088,0.41,S1313
6,DIWAKAR HARIJI URADE,Independent,3221,3,3224,0.26,S1313
7,NAMDEO MANIKRAO SHEDMAKE,Gondvana Gantantra Party,2238,18,2256,0.18,S1313
8,SEWAKDAS KAWDUJI BARKE,Peoples Party of India (Democratic),1997,1,1998,0.16,S1313
9,AWACHIT SHAMRAO SAYAM,Janseva Gondwana Party,1886,20,1906,0.15,S1313
10,MILIND PRALHAD DAHIWALE,Independent,1759,2,1761,0.14,S1313
11,ASHOK RANAJI RATHOD,Jay Vidarbha Party,1660,10,1670,0.13,S1313
12,VIKAS UTTAMRAO LASANTE,Sanman Rajkiya Paksha,1518,2,1520,0.12,S1313
13,VIDYASAGAR KALIDAS KASARLAWAR,Bhim Sena,1426,0,1426,0.11,S1313
14,VANITA JITENDRA RAUT,Akhil Bharatiya Manavata Paksha,1054,3,1057,0.09,S1313
15,PURNIMA DILIP GHONMODE,Bahujan Republican  Socialist Party,967,6,973,0.08,S1313
16,NOTA,None of the Above,10821,22,10843,0.87,S1313
1,AMARSING TISSO,Bharatiya Janata Party,332440,2180,334620,49.01,S036
2,J. I. KATHAR,Independent,185864,1153,187017,27.39,S036
3,JOY RAM ENGLENG,Indian National Congress,123055,964,124019,18.16,S036
4,JOHN BARNARD SANGMA,Gana Suraksha Party,11241,38,11279,1.65,S036
5,JOTSON BEY,Autonomous State Demand Committee,9561,72,9633,1.41,S036
6,NOTA,None of the Above,16127,132,16259,2.38,S036
1,KAKOLI GHOSH DASTIDAR,All India Trinamool Congress,689513,2497,692010,45.15,S2517
2,SWAPAN MAJUMDER,Bharatiya Janata Party,576024,1797,577821,37.7,S2517
3,TAPAS BANERJEE,All India Secular Front,121355,85,121440,7.92,S2517
4,SANJIB CHATTERJEE,All India Forward Bloc,99456,544,100000,6.52,S2517
5,SMRITIKANA HAOLADAR,Bahujan Samaj Party,5759,28,5787,0.38,S2517
6,SAIFUDDIN MONDAL,Independent,3823,4,3827,0.25,S2517
7,SWAPAN MAJUMDAR,Independent,3083,2,3085,0.2,S2517
8,S MUKHTAR AHMED,Independent,2639,8,2647,0.17,S2517
9,SEFALI DEY,Bharatiya Nyay-Adhikar Raksha Party,2244,8,2252,0.15,S2517
10,SADHAN GHOSH,Socialist Unity Centre Of India (COMMUNIST),2025,22,2047,0.13,S2517
11,BIKASH SARKAR,Mulnibasi Party of India,1928,1,1929,0.13,S2517
12,MOHAN LAL ADHIKARY,Independent,1850,14,1864,0.12,S2517
13,NOTA,None of the Above,17834,58,17892,1.17,S2517
1,MUKESHKUMAR CHANDRAKAANT DALAL ( Uncontested ),Bharatiya Janata Party,0,0,0,0,S0624
1,AMAR SHARADRAO KALE,Nationalist Congress Party – Sharadchandra Pawar,530761,2345,533106,48.68,S138
2,RAMDAS CHANDRABHAN TADAS,Bharatiya Janata Party,449599,1859,451458,41.23,S138
3,DR. MOHAN RAMRAOJI  RAIKWAR,Bahujan Samaj Party,20653,142,20795,1.9,S138
4,PROF. RAJENDRA GULABRAO  SALUNKHE,Vanchit Bahujan  Aaghadi,15408,84,15492,1.41,S138
5,ASIF,Independent,15176,6,15182,1.39,S138
6,KISHOR BABA PAVAR,Independent,12917,3,12920,1.18,S138
7,SUHAS V. THAKARE,Independent,7639,9,7648,0.7,S138
8,AKSHAY MEHARE BHARTIYA,Akhil Bhartiya Parivar Party,5446,21,5467,0.5,S138
9,MAROTI GULABRAO UIKE,Gondvana Gantantra Party,4651,21,4672,0.43,S138
10,ADV. BHASKAR MAROTRAO  NEWARE,Independent,4021,11,4032,0.37,S138
11,JAGADISH UDDVRAO  WANKHADE,Independent,2338,11,2349,0.21,S138
12,POOJA PANKAJ TADAS,Independent,2121,14,2135,0.19,S138
13,ANIL K. GHUSHE,Independent,1967,4,1971,0.18,S138
14,ASHISH LEKHIRAM IZANKAR,Vidarbha Rajya Aghadi,1819,9,1828,0.17,S138
15,VIJAY DNYANESHWARRAO  SHRIRAO,Independent,1723,15,1738,0.16,S138
16,ARVIND SHAMRAO LILLORE,Independent,1475,1,1476,0.13,S138
17,RAMRAO BAJIRAO GHODASKAR,All India Forward Bloc,1418,20,1438,0.13,S138
18,KRUSHNA SUBHASHRAO FULKARI,Lok Swarajya Party,1342,1,1343,0.12,S138
19,UMESH SOMAJI WAWARE,Maharashtra Vikas Aghadi,1231,15,1246,0.11,S138
20,KRUSHNA ANNAJI KALODE,Hindrashtra Sangh,1052,9,1061,0.1,S138
21,RAMESH SINHA,Independent,799,0,799,0.07,S138
22,DR. MORESHWAR RAMJI NAGRALE,Republican Party of India,792,5,797,0.07,S138
23,DIXITA ANAND,Desh Janhit Party,731,5,736,0.07,S138
24,RAHUL T. BHOYAR,Independent,685,4,689,0.06,S138
25,NOTA,None of the Above,4583,51,4634,0.42,S138
1,AJAY KUMAR MANDAL,Janata Dal  (United),534923,1108,536031,50.38,S0426
2,AJEET SHARMA,Indian National Congress,430025,1138,431163,40.52,S0426
3,POONAM SINGH,Bahujan Samaj Party,12547,99,12646,1.19,S0426
4,HARERAM YADAV,Independent,12255,3,12258,1.15,S0426
5,DEEPAK KUMAR SINGH,Rashtriya Jansambhavna Party,7654,16,7670,0.72,S0426
6,CHHOTE LAL KUMAR,Independent,6677,6,6683,0.63,S0426
7,RAMESH TUDU,Independent,6629,5,6634,0.62,S0426
8,UMESH PRASAD YADAV,Peoples Party of India (Democratic),5105,21,5126,0.48,S0426
9,DEEPAK KUMAR,Socialist Unity Centre Of India (COMMUNIST),3758,5,3763,0.35,S0426
10,MUKESH KUMAR,Akhil Bhartiya Parivar Party,3670,11,3681,0.35,S0426
11,DAYARAM MANDAL,Lok Sewa Dal,3509,10,3519,0.33,S0426
12,OM PRAKASH PODDAR,Independent,3091,13,3104,0.29,S0426
13,NOTA,None of the Above,31771,32,31803,2.99,S0426
1,KAMAKHYA PRASAD TASA,Bharatiya Janata Party,892766,4277,897043,55.04,S0310
2,ROSELINA TIRKEY,Indian National Congress,646123,1973,648096,39.76,S0310
3,DILUWARA BEGUM CHOWDHURY,Independent,11719,24,11743,0.72,S0310
4,BINOD GOGOI,Independent,10625,54,10679,0.66,S0310
5,ANIMA DEKA GUPTA,Voters Party  International,8641,32,8673,0.53,S0310
6,TRIDIV JYOTI BHUYAN,Independent,8091,37,8128,0.5,S0310
7,ABDUL HOQUE,Independent,6395,46,6441,0.4,S0310
8,JYOTISKA RANJAN GOSWAMI,Independent,4494,44,4538,0.28,S0310
9,SAILEN CH MALAKAR,Bharatiya Gana Parishad,3698,22,3720,0.23,S0310
10,SALIM AHMED,Asom Jana Morcha,3243,23,3266,0.2,S0310
11,SALEH AHMED MAZUMDAR,Republican Party of India (Athawale),3160,19,3179,0.2,S0310
12,NOTA,None of the Above,24212,219,24431,1.5,S0310
1,BHUPENDER YADAV,Bharatiya Janata Party,624110,7882,631992,50.42,S208
2,LALIT YADAV,Indian National Congress,575964,7746,583710,46.57,S208
3,FAZAL HUSSAIN,Bahujan Samaj Party,19178,109,19287,1.54,S208
4,PARDEEP KUMAR,Sarv Samaj Party,4339,23,4362,0.35,S208
5,VIVEK JAIN,Independent,2429,9,2438,0.19,S208
6,RAMBABU SHARMA,Independent,2207,25,2232,0.18,S208
7,AMIT GUPTA,Independent,1366,23,1389,0.11,S208
8,CHHAGAN LAL,Independent,1291,36,1327,0.11,S208
9,VISHVNATH KHINCHI,Hindustan Janta Party,862,17,879,0.07,S208
10,NOTA,None of the Above,5727,95,5822,0.46,S208
1,RODMAL NAGAR,Bharatiya Janata Party,756139,2604,758743,53.1,S1220
2,DIGVIJAYA SINGH,Indian National Congress,610602,2052,612654,42.87,S1220
3,DR. RAJENDRA SURYAVANSHI,Bahujan Samaj Party,13902,40,13942,0.98,S1220
4,ASHOK PAWAR,Samata Samadhan Party,6597,17,6614,0.46,S1220
5,JITENDRA SINGH,National World Leader Party,5051,12,5063,0.35,S1220
6,DINESH RAZAWAT,Aazad Samaj Party (Kanshi Ram),4170,9,4179,0.29,S1220
7,RODMAL,Independent,3733,11,3744,0.26,S1220
8,ANIL JAIN,Independent,3069,20,3089,0.22,S1220
9,RADHESHYAM MALVIYA,Independent,2796,3,2799,0.2,S1220
10,SUNEEL BHEEL,Independent,2703,10,2713,0.19,S1220
11,VISHAL SONI (ADVOCATE),Bharatiya Yuva Jan Ekta Party,2544,16,2560,0.18,S1220
12,JAGDISH KARPENTER,Independent,1730,4,1734,0.12,S1220
13,ANIL,Independent,1414,4,1418,0.1,S1220
14,RAMCHARAN PIRJAPATI,Lok Samaj Party,1292,2,1294,0.09,S1220
15,BABU SINGH,Sajag Samaj Party,1186,5,1191,0.08,S1220
16,NOTA,None of the Above,7248,12,7260,0.51,S1220
1,ASADUDDIN OWAISI,All India Majlis-E-Ittehadul Muslimeen,659278,2703,661981,61.28,S299
2,MADHAVI LATHA KOMPELLA,Bharatiya Janata Party,320481,3413,323894,29.98,S299
3,MOHAMMED WALIULLAH SAMEER,Indian National Congress,62497,465,62962,5.83,S299
4,SRINIVAS YADAV GADDAM,Bharat Rashtra Samithi,18498,143,18641,1.73,S299
5,MEKALA RAGHUMA REDDY,Yuga Thulasi Party,2231,1,2232,0.21,S299
6,DR.J.PADMAJA,Viduthalai Chiruthaigal Katchi,899,1,900,0.08,S299
7,K.S.KRISHNA,Bahujan Samaj Party,763,6,769,0.07,S299
8,RAMESH KUMAR MATANGI,Sakala Janula Party,663,0,663,0.06,S299
9,KRANTHI KUMAR BANDELA,Indian National Yuva Jana Party,561,1,562,0.05,S299
10,M.JOHNSON,All India Mahila Empowerment Party,515,0,515,0.05,S299
11,JAMEEL SAYED,Alliance of Democratic Reforms Party,492,0,492,0.05,S299
12,ASHOK KUMAR MAMBA,Maa Telangana Party,422,1,423,0.04,S299
13,DR.LUBNA SARWATH,Vidhyarthula Rajakiya Party,410,1,411,0.04,S299
14,SARAF TULASI GUPTA,Praja Ektha Party,281,0,281,0.03,S299
15,V.SHANKER,Yuva Taram Party,275,1,276,0.03,S299
16,GADDAM HARISH GOUD,Dharma Samaj Party,269,2,271,0.03,S299
17,SYED ANWAR,Independent,251,0,251,0.02,S299
18,KHAJA MOINUDDIN,All India Majlis-E-Inquilab-E-Millat,233,1,234,0.02,S299
19,AMJAD KHAN,Independent,195,1,196,0.02,S299
20,AMBI HANUMANTH RAO,Socialist Party (India),161,1,162,0.01,S299
21,SHAIK BASHA,Dalita Bahujana Party,153,0,153,0.01,S299
22,M.K.AHMED,Independent,149,0,149,0.01,S299
23,SALVERU RAMESH,Indian Praja Congress,141,0,141,0.01,S299
24,L.ASHOKNATH,Telangana Prajaa Jeevana Rythu Party,141,0,141,0.01,S299
25,J.SHYAMSUNDER RAO,Independent,138,0,138,0.01,S299
26,ANDE USHA KANNA,Bahujan Mukti Party,133,0,133,0.01,S299
27,SATTI SHABABU REDDY,Independent,123,0,123,0.01,S299
28,ANIL SEN,Independent,111,0,111,0.01,S299
29,CHAITANYA KUMAR REDDY PELLAKURU,Independent,110,0,110,0.01,S299
30,SILIVERU NARESH,Telangana Jaghir Party,103,0,103,0.01,S299
31,NOTA,None of the Above,2867,39,2906,0.27,S299
1,BANDYOPADHYAY SUDIP,All India Trinamool Congress,453177,1519,454696,47.44,S2524
2,TAPAS ROY,Bharatiya Janata Party,361268,868,362136,37.78,S2524
3,PRADIP BHATTACHARYA,Indian National Congress,114556,426,114982,12,S2524
4,DR. BIPLAB CHANDRA,Socialist Unity Centre Of India (COMMUNIST),3640,18,3658,0.38,S2524
5,OMPRAKASH PRAJAPATI,Bahujan Samaj Party,3133,47,3180,0.33,S2524
6,PRANATI PAUL,Independent,2267,5,2272,0.24,S2524
7,SURENDRA KUMAR KABRA,Independent,1317,5,1322,0.14,S2524
8,SWAPAN DAS,Independent,1163,3,1166,0.12,S2524
9,MISBAHUS SALAM,Independent,975,6,981,0.1,S2524
10,SAMPA GUHA,Bharatiya Nyay-Adhikar Raksha Party,912,4,916,0.1,S2524
11,RAJKUMAR PALIT,Mission Naya Digant Party,768,4,772,0.08,S2524
12,SMT. RINKU GUPTA,Pyramid Party of India,649,10,659,0.07,S2524
13,AMAL KUMAR DEY,Independent,582,9,591,0.06,S2524
14,ANUJIT KUMAR NAN,Independent,555,2,557,0.06,S2524
15,BINOY KRISHNA CHATTERJEE,Independent,500,1,501,0.05,S2524
16,NOTA,None of the Above,10004,40,10044,1.05,S2524
1,RAJABHAU (PARAG) PRAKASH WAJE,Shiv Sena (Uddhav Balasaheb Thackrey),614517,2212,616729,49.85,S1321
2,GODSE HEMANT TUKARAM,Shiv Sena,453414,1314,454728,36.75,S1321
3,KARAN PANDHARINATH GAIKAR,Vanchit Bahujan  Aaghadi,47114,79,47193,3.81,S1321
4,SHANTIGIRIJI MAUNGIRIJI MAHARAJ,Independent,44415,109,44524,3.6,S1321
5,ARUN MADHUKAR KALE,Bahujan Samaj Party,7698,53,7751,0.63,S1321
6,CHANDRAKANT KESHAVRAO THAKUR,Independent,6607,1,6608,0.53,S1321
7,AMOL SAMPATRAO KAMBLE,Rashtriya Kisan Bahujan Party,4980,17,4997,0.4,S1321
8,DARSHANA AMOL MEDHE,Prabuddha Republican Party,4730,6,4736,0.38,S1321
9,KANOJE PRAKASH GIRDHARI,Independent,3917,3,3920,0.32,S1321
10,VAMAN MAHADEV SANGALE,Dharmarajya Paksha,3861,0,3861,0.31,S1321
11,SUDHIR SHRIDHAR DESHMUKH,Independent,3162,5,3167,0.26,S1321
12,JITENDRA NARESH BHABHE (JITENDRA BHAVE),Independent,3125,7,3132,0.25,S1321
13,ARIF USMAN MANSURI,Independent,2538,5,2543,0.21,S1321
14,GANESH BALASAHEB BORASTE,Independent,2403,1,2404,0.19,S1321
15,JAYSHRI MAHENDRA PATIL,Sainik Samaj Party,2398,28,2426,0.2,S1321
16,SIDDHESHWARANAND SARASWATI,Independent,2378,10,2388,0.19,S1321
17,SUSHAMA ABHIJIT GORANE,Independent,2258,2,2260,0.18,S1321
18,KANTILAL KISAN JADHAV,Ambedkarite Party of India,2047,8,2055,0.17,S1321
19,CHANDRABHAN AABAJI PURKAR,Independent,1888,2,1890,0.15,S1321
20,YASHWANT VALU PARDHI,Bhartiya Asmita Party,1867,7,1874,0.15,S1321
21,KAILASH MARUTI CHAVAN,Aam Janta Party (India),1686,17,1703,0.14,S1321
22,KAMLAKAR BALASAHEB GAIKWAD,Dalit Soshit Pichhara Varg  Adhikar Dal,1639,7,1646,0.13,S1321
23,DHANAJI ASHOK TOPALE,Independent,1376,0,1376,0.11,S1321
24,BHAGYASHRI NITIN ADSUL,Indian Peoples Adhikar Party,1242,2,1244,0.1,S1321
25,SOPAN NIVRUTTI SOMWANSHI,Independent,1210,1,1211,0.1,S1321
26,ADV. ZUNJAR MHASUJI AVHAD,Bahujan Republican  Socialist Party,1205,5,1210,0.1,S1321
27,KOLAPPA HANUMANT DHOTRE,Independent,1198,2,1200,0.1,S1321
28,TILOTTAMA SUNIL JAGTAP,Independent,654,2,656,0.05,S1321
29,DEEPAK GAIKWAD,Independent,640,2,642,0.05,S1321
30,SACHINRAJE DATTATREYA DEORE,Independent,549,2,551,0.04,S1321
31,DEVIDAS PIRAJI SARKATE,Independent,392,2,394,0.03,S1321
32,NOTA,None of the Above,6144,41,6185,0.5,S1321
1,IQRA CHOUDHARY,Samajwadi Party,526887,1126,528013,48.9,S242
2,PRADEEP KUMAR,Bharatiya Janata Party,456075,2822,458897,42.5,S242
3,SRIPAL,Bahujan Samaj Party,75978,222,76200,7.06,S242
4,JAHID,Social Democratic Party Of India,3316,4,3320,0.31,S242
5,SHOKINDER KUMAR,Independent,1983,2,1985,0.18,S242
6,MANOJ RANA,Independent,1925,11,1936,0.18,S242
7,VIKAS KUMAR,Independent,1098,2,1100,0.1,S242
8,OMBEER,Azad Adhikar Sena,1088,8,1096,0.1,S242
9,VIKRAM SINGH,Independent,897,3,900,0.08,S242
10,PRITI KASHYAP,Rashtriya Mazdoor Ekta Party,781,10,791,0.07,S242
11,VIKRAM SAINI,Akhand Bharat Swatantra Party,776,4,780,0.07,S242
12,YOGESH,Independent,664,6,670,0.06,S242
13,MOHD KADIR,Independent,436,6,442,0.04,S242
14,NAND KISHOOR,Aapki Apni Party (Peoples),420,7,427,0.04,S242
15,NOTA,None of the Above,3213,36,3249,0.3,S242
1,JYOTSNA CHARANDAS MAHANT,Indian National Congress,569098,1084,570182,46.53,S264
2,SAROJ PANDEY,Bharatiya Janata Party,525733,1166,526899,43,S264
3,SHYAM SINGH MARKAM,Gondvana Gantantra Party,48498,89,48587,3.97,S264
4,NIRDOSH  KUMAR YADAV,Independent,11267,1,11268,0.92,S264
5,DUJRAM BOUDDH,Bahujan Samaj Party,10689,50,10739,0.88,S264
6,JAICHANDRA SONPAKAR,Independent,6181,1,6182,0.5,S264
7,PALAN SINGH,Independent,5706,3,5709,0.47,S264
8,KAMAL DEV,Bhartiya Shakti Chetna Party,4985,3,4988,0.41,S264
9,DILIP MIRI,Independent,3897,5,3902,0.32,S264
10,KAUSHALYA BAI PORTE,Independent,3630,2,3632,0.3,S264
11,PRATAP BHANU,Independent,2500,4,2504,0.2,S264
12,SANTOSH SHARMA,Independent,2475,2,2477,0.2,S264
13,AMRIKA KARPE,Independent,2227,5,2232,0.18,S264
14,RAJGURU KEWAL GOSWAMI,Independent,2202,0,2202,0.18,S264
15,SHOBRAN SINGH SAIMA,Independent,2072,1,2073,0.17,S264
16,KALYAN SINGH TANWAR,Independent,1960,4,1964,0.16,S264
17,RAJESH PANDEY,Independent,1814,0,1814,0.15,S264
18,SUSHIL KUMAR VISHWAKARMA,Bhartiya Janta Secular Party,1684,1,1685,0.14,S264
19,PRASHANT DANIEL,Sarv Adi Dal,1369,23,1392,0.11,S264
20,REKHA TIWARI,Chhattisgarh Vikas Ganga Rashtriya Party,1289,5,1294,0.11,S264
21,PURUSHOTTAM MANIKPURI,Independent,1212,0,1212,0.1,S264
22,PRIYANKA PATEL,Republican Party of India (A),1197,7,1204,0.1,S264
23,MAHENDRA KUMAR SHRIWAS (MANJU),Independent,1187,0,1187,0.1,S264
24,SHEKH RAUF,Independent,1168,0,1168,0.1,S264
25,SHIVPUJAN SINGH,Independent,1036,0,1036,0.08,S264
26,SHANTI BAI MARAVI,Independent,858,3,861,0.07,S264
27,RAMESH DAS MAHANT,Independent,823,0,823,0.07,S264
28,NOTA,None of the Above,6076,21,6097,0.5,S264
1,KALI CHARAN MUNDA,Indian National Congress,503997,7650,511647,54.62,S2711
2,ARJUN MUNDA,Bharatiya Janata Party,358076,3896,361972,38.64,S2711
3,SAVITRI DEVI,Bahujan Samaj Party,12202,98,12300,1.31,S2711
4,BASANT KUMAR LONGA,Independent,10735,20,10755,1.15,S2711
5,ARPANA HANS,Jharkhand Party,8450,82,8532,0.91,S2711
6,PASTAR SANJAY KUMAR TIRKEY,Independent,4944,19,4963,0.53,S2711
7,BABITA KACHHAP,Bharat Adivasi Party,4507,87,4594,0.49,S2711
8,NOTA,None of the Above,21814,105,21919,2.34,S2711
1,NARENDRA MODI,Bharatiya Janata Party,611439,1531,612970,54.24,S2477
2,AJAY RAI,Indian National Congress,459084,1373,460457,40.74,S2477
3,ATHER JAMAL LARI,Bahujan Samaj Party,33646,120,33766,2.99,S2477
4,KOLISETTY SHIVA KUMAR,Yuga Thulasi Party,5748,2,5750,0.51,S2477
5,GAGAN PRAKASH YADAV,Apna Dal (Kamerawadi),3619,15,3634,0.32,S2477
6,DINESH KUMAR YADAV,Independent,2912,5,2917,0.26,S2477
7,SANJAY KUMAR TIWARI,Independent,2170,1,2171,0.19,S2477
8,NOTA,None of the Above,8463,15,8478,0.75,S2477
1,KULDEEP INDORA,Indian National Congress,719896,6596,726492,51.4,S201
2,PRIYANKA BALAN MEGHWAL,Bharatiya Janata Party,632097,6242,638339,45.16,S201
3,DEVKARAN NAYAK,Bahujan Samaj Party,16090,212,16302,1.15,S201
4,RAJKUMAR,Independent,4350,25,4375,0.31,S201
5,KULWANT KAUR,Indian Peoples Green Party,4338,24,4362,0.31,S201
6,DAYA RAM,Independent,3285,434,3719,0.26,S201
7,RAJENDER KUMAR,Bhartiya Jan Samman Party,2383,60,2443,0.17,S201
8,KANA RAM,Independent,2248,18,2266,0.16,S201
9,MAJOR SINGH,Jai Hind Congress Party,2075,26,2101,0.15,S201
10,NOTA,None of the Above,12940,155,13095,0.93,S201
1,BAJRANG MANOHAR SONWANE,Nationalist Congress Party – Sharadchandra Pawar,682532,1418,683950,44.93,S1339
2,PANKAJA GOPINATHRAO MUNDE,Bharatiya Janata Party,675349,2048,677397,44.5,S1339
3,ASHOK BHAGOJI THORAT,Bahujan Maha Party,54829,21,54850,3.6,S1339
4,ASHOK SUKHDEV HINGE,Vanchit Bahujan  Aaghadi,50741,126,50867,3.34,S1339
5,SHAIKH TOUSIF ABDUL SATTAR,Independent,9472,0,9472,0.62,S1339
6,DR. SIDDHARTH RAJENDRA TAKANKAR,Bahujan Samaj Party,5092,19,5111,0.34,S1339
7,SHAMSHER KHAN SAHEB KHAN PATHAN,Independent,4704,0,4704,0.31,S1339
8,JAVED SIKANDAR MOMIN,Independent,2662,0,2662,0.17,S1339
9,NAZEM KHAN JABBAR KHAN PATHAN,Independent,2586,0,2586,0.17,S1339
10,GOKUL BAPURAO SAWASE,Independent,2576,1,2577,0.17,S1339
11,GAFFARKHAN JABBARKHAN PATHAN,Independent,2561,2,2563,0.17,S1339
12,DATTA SUDAM GAIKWAD,Independent,2130,0,2130,0.14,S1339
13,SATISH PADMAKAR KAPSE,Independent,2098,1,2099,0.14,S1339
14,KARUNA DHANANJAY MUNDE,Swarajya Shakti Sena,1594,5,1599,0.11,S1339
15,DR. SHRIRAM VITTHALRAO KHALGE,Independent,1512,0,1512,0.1,S1339
16,ADV. GANESH NAVNATHRAO KARANDE,Independent,1506,2,1508,0.1,S1339
17,SHITAL SHIVAJI DHONDRE,Independent,1302,1,1303,0.09,S1339
18,SHAIKH YASHED SHAIKH TAYYAB,Independent,1258,0,1258,0.08,S1339
19,JAWED SALEEM SYED,Tipu Sultan Party,972,6,978,0.06,S1339
20,PRAKASH BHAGWANRAO SOLANKE,Independent,885,1,886,0.06,S1339
21,CHANDRAKANT KUMAR HAJARE,Maharashtra Vikas Aghadi,800,3,803,0.05,S1339
22,SALAUDDIN KHAN PATHAN,Independent,724,0,724,0.05,S1339
23,KASPATE GANESH VYANKATRAO,Independent,719,0,719,0.05,S1339
24,MUBEEN ZUBERI ZAHEER UL AFAQUE,Independent,675,1,676,0.04,S1339
25,WASIM SHAIKH SALIM SHAIKH,Independent,579,1,580,0.04,S1339
26,SHAIKH EJAJ SHAIKH UMAR,Independent,550,0,550,0.04,S1339
27,SHESHERAO CHOKHOBA VEER,Prabuddha Republican Party,537,0,537,0.04,S1339
28,TATE MAHENDRA ASHOK,Ambedkarist Republican Party,531,2,533,0.04,S1339
29,MUSTAFA MAINODDIN SHAIKH,Independent,531,0,531,0.03,S1339
30,SULEMAN KHAIRODDIN MOHMMAD,Independent,522,0,522,0.03,S1339
31,HIDAYAT SADEKH ALI SYED,Independent,448,0,448,0.03,S1339
32,RAJENDRA ACHYUTRAO HOKE,Independent,427,0,427,0.03,S1339
33,ADV. MANIK BANSI AADMANE,Bahujan Republican  Socialist Party,425,1,426,0.03,S1339
34,VACHISHT UDDHAV KUTE,Independent,414,0,414,0.03,S1339
35,ADV. SHARAD BAHINAJI KAMBLE,All India National Raksha Sena,393,3,396,0.03,S1339
36,BHASKAR BANSIDHARRAO KHANDE,Independent,390,0,390,0.03,S1339
37,RAHEMAN BAHODDIN SAYYED,Independent,384,0,384,0.03,S1339
38,LAXMIBAI BAJIRAO MORE,Independent,382,0,382,0.03,S1339
39,SYED MINHAJ ALI,Independent,310,0,310,0.02,S1339
40,SALIM ALLABAKSHA SAYYAD,Independent,238,0,238,0.02,S1339
41,SADEK IBRAHIM SHAIKH,Independent,206,0,206,0.01,S1339
42,NOTA,None of the Above,2068,19,2087,0.14,S1339
1,E.T.  MOHAMMED BASHEER,Indian Union Muslim League,640269,3737,644006,59.35,S116
2,V. VASEEF,Communist Party of India  (Marxist),341510,2378,343888,31.69,S116
3,DR. ABDUL SALAM,Bharatiya Janata Party,84529,832,85361,7.87,S116
4,T. KRISHNAN,Bahujan Samaj Party,1392,25,1417,0.13,S116
5,P.C. NARAYANAN,Bahujan Dravida Party,1304,5,1309,0.12,S116
6,NASEEF ALI MULLAPPALLI,Independent,1154,14,1168,0.11,S116
7,ABDULSALAM S/O MUHAMMED HAJI,Independent,771,12,783,0.07,S116
8,THRISSUR NAZEER,Independent,459,25,484,0.04,S116
9,NOTA,None of the Above,6650,116,6766,0.62,S116
1,TOKHAN SAHU,Bharatiya Janata Party,723194,1743,724937,53.25,S265
2,DEVENDRA YADAV,Indian National Congress,558942,1437,560379,41.16,S265
3,ASHWANI RAJAK,Bahujan Samaj Party,13175,47,13222,0.97,S265
4,ANAND URAWAN,Independent,5894,4,5898,0.43,S265
5,ANILESH MISHRA (MAHARAJ),Independent,5374,2,5376,0.39,S265
6,KULESH KUMAR SAHU,Independent,4439,4,4443,0.33,S265
7,ASHAVANT SAHOO,Bhartiya Shakti Chetna Party,4345,9,4354,0.32,S265
8,SHRIKANT MALHWAYR (KASER),Loktantra Congress Party,4197,4,4201,0.31,S265
9,VIKRAMPRASAD JOGI,Independent,2862,0,2862,0.21,S265
10,KESHAV PRASAD,Independent,2765,2,2767,0.2,S265
11,SUDIEP SHRIVASTAVA,Hamar Raj Party,2310,2,2312,0.17,S265
12,RUPRAM SAHU,Independent,2261,0,2261,0.17,S265
13,KRISHNA NANDAN SINGH,Independent,2020,0,2020,0.15,S265
14,ROSHAN KUMAR,Independent,1920,0,1920,0.14,S265
15,DINESH PRATAP SINGH KHUSRO NIKHIL,Rashtriya Gondvana Party,1792,16,1808,0.13,S265
16,RAMESHWAR SAHU,Independent,1761,0,1761,0.13,S265
17,VIJAY KUMAR,Independent,1625,1,1626,0.12,S265
18,YASHUTOSH LAHARE,Ambedkarite Party of India,1271,3,1274,0.09,S265
19,GHANSHYAM URF SADHELAL BHARDWAJ,Independent,1251,0,1251,0.09,S265
20,VEDMANI SINGH KSHATRIYA (THAKUR),Independent,1163,0,1163,0.09,S265
21,SHEKHAR BANJARE,Independent,1160,0,1160,0.09,S265
22,SIDDHRAM LAHARE,Rashtriya Jansabha Party,1149,1,1150,0.08,S265
23,RAMPYARE RAI,Independent,1112,0,1112,0.08,S265
24,NAND KISHORE RAJ,Gondvana Gantantra Party,1049,12,1061,0.08,S265
25,BHUNESHWAR MARKO,Independent,967,3,970,0.07,S265
26,RAJKUMAR SAHU,Independent,828,1,829,0.06,S265
27,BHAGWAT PATRE,Prabuddha Republican Party,710,2,712,0.05,S265
28,LAKSHMAN  PATHAK,Ekam Sanatan Bharat Dal,698,1,699,0.05,S265
29,ADVOCATE SHAILENDRA BANJARE (SHAKTIPUTRA),Shakti Sena (Bharat Desh),690,0,690,0.05,S265
30,RAJENDRA KUMAR TANDAN,Independent,654,2,656,0.05,S265
31,SALIK RAM JOGI,Independent,575,1,576,0.04,S265
32,BASANT BANSL,Independent,564,0,564,0.04,S265
33,DEEPMALA CHOUHAN,Chhattisgarh Vikas Ganga Rashtriya Party,559,6,565,0.04,S265
34,MAHESH KUMAR SONWANI,Independent,559,1,560,0.04,S265
35,DEV PRASAD BRAIHA,Independent,511,0,511,0.04,S265
36,SANJAY PRAKASH SAHU,Independent,435,1,436,0.03,S265
37,PARAS RAM YADAV,Independent,414,1,415,0.03,S265
38,NOTA,None of the Above,2842,7,2849,0.21,S265
1,ADITYA YADAV,Samajwadi Party,501390,465,501855,45.97,S2423
2,DURVIJAY SINGH SHAKYA,Bharatiya Janata Party,466323,541,466864,42.76,S2423
3,MUSLIM KHAN,Bahujan Samaj Party,97686,65,97751,8.95,S2423
4,SANDEEP KUMAR,Independent,3835,1,3836,0.35,S2423
5,DINESH KUMAR,Independent,2672,2,2674,0.24,S2423
6,LATA YADAV,Independent,2572,6,2578,0.24,S2423
7,NILAM RANI PAL,Rashtriya Shoshit Samaj Party,2428,10,2438,0.22,S2423
8,RAM PRATAP MAURYA,Independent,1542,1,1543,0.14,S2423
9,ISRAT ALI,Independent,1512,1,1513,0.14,S2423
10,SULEMAN,Swaraj Bhartiya Nyay Party,1240,0,1240,0.11,S2423
11,HARIRAJ SINGH URF SIPU YADAV,Log Party,909,1,910,0.08,S2423
12,NOTA,None of the Above,8553,9,8562,0.78,S2423
1,RAJKUMAR CHAHAR,Bharatiya Janata Party,442862,2795,445657,43.09,S2419
2,RAMNATH SINGH SIKARWAR,Indian National Congress,400572,1680,402252,38.9,S2419
3,PT.  RAMNIWAS SHARMA,Bahujan Samaj Party,120143,396,120539,11.66,S2419
4,DR RAMESHWAR SINGH,Independent,48301,305,48606,4.7,S2419
5,KALLAN KUMBHKAR,Independent,3458,5,3463,0.33,S2419
6,HOTAM SINGH NISHAD,Rashtriya Shoshit Samaj Party,1805,5,1810,0.18,S2419
7,GIRRAJ SINGH DHAKREY,"Proutist Bloc, India",1556,8,1564,0.15,S2419
8,SANGEETA TOMAR,Bharatiya Majdoor Janta Party,1417,16,1433,0.14,S2419
9,VED PRAKASH,Rashtriya Jansanchar Dal,1031,7,1038,0.1,S2419
10,NOTA,None of the Above,7764,29,7793,0.75,S2419
1,VIJAY BAGHEL,Bharatiya Janata Party,954356,2141,956497,62,S267
2,RAJENDRA SAHU,Indian National Congress,517277,994,518271,33.59,S267
3,DILIP RAMTEKE,Bahujan Samaj Party,13290,43,13333,0.86,S267
4,ANOOP KUMAR PANDEY,Independent,7765,1,7766,0.5,S267
5,DR. ANJU KEME,Ekam Sanatan Bharat Dal,5237,4,5241,0.34,S267
6,ALI HUSSAIN SIDDIQUI,Independent,5046,4,5050,0.33,S267
7,ARUN JOSHI,Independent,4751,2,4753,0.31,S267
8,DHRUV KUMAR SONI URF LANGUR SONI,Independent,3813,2,3815,0.25,S267
9,KHILANAND JASPAL,Independent,3280,1,3281,0.21,S267
10,SUKHADEV TANDON,Rashtriya Jansabha Party,2615,2,2617,0.17,S267
11,ASHOK JAIN,Independent,1902,0,1902,0.12,S267
12,BALDEV SAHU,Independent,1610,3,1613,0.1,S267
13,PUSHPA MAIRISHA,Ambedkarite Party of India,1556,5,1561,0.1,S267
14,HARICHAND THAKUR,Independent,1451,1,1452,0.09,S267
15,SAVITA SHAILENDRA BANJARE,Shakti Sena (Bharat Desh),1393,3,1396,0.09,S267
16,RAKESH SAHU,Nyaydharmsabha,1261,1,1262,0.08,S267
17,SHITKARAN MAHILWAR,Aazad Samaj Party (Kanshi Ram),1181,2,1183,0.08,S267
18,DR. HARISHCHANDRA SAHU,Independent,1116,0,1116,0.07,S267
19,SHANKAR THAKUR,Gondvana Gantantra Party,1064,9,1073,0.07,S267
20,YASHWANT SITARAM SAHU,Bhartiya Shakti Chetna Party,899,2,901,0.06,S267
21,SHYAM SUNDER SAHU,Loktantra Congress Party,897,2,899,0.06,S267
22,VIKAS SHARMA,Lokshahi Ekta Party,798,0,798,0.05,S267
23,SANTOSH KUMAR MARKANDE,Independent,646,4,650,0.04,S267
24,BHAGBALI SIVARE,Independent,388,1,389,0.03,S267
25,BHANUPRATAP CHATURVEDI,Independent,351,0,351,0.02,S267
26,NOTA,None of the Above,5596,21,5617,0.36,S267
1,AJAY TAMTA,Bharatiya Janata Party,417535,11632,429167,64.2,S283
2,PRADEEP TAMTA,Indian National Congress,191642,3428,195070,29.18,S283
3,NARAYAN RAM,Bahujan Samaj Party,9840,235,10075,1.51,S283
4,KIRAN ARYA,Uttarakhand Parivartan Party,5528,250,5778,0.86,S283
5,ARJUN PRASAD,Independent,4591,116,4707,0.7,S283
6,DR PRAMOD KUMAR,Peoples Party of India (Democratic),4401,56,4457,0.67,S283
7,ER JYOTI PRAKASH TAMTA,Bahujan Mukti Party,2178,46,2224,0.33,S283
8,NOTA,None of the Above,16697,322,17019,2.55,S283
1,NARESH CHANDRA UTTAM PATEL,Samajwadi Party,499866,462,500328,45.2,S2449
2,NIRANJAN JYOTI,Bharatiya Janata Party,466249,880,467129,42.2,S2449
3,MANISH SINGH SACHAN,Bahujan Samaj Party,90897,73,90970,8.22,S2449
4,BIRENDRA SINGH,Independent,7917,3,7920,0.72,S2449
5,KAMLESH KUMAR SINGH,Parivartan Samaj Party,5212,7,5219,0.47,S2449
6,PANKAJ AWASTHI,Independent,4456,1,4457,0.4,S2449
7,RAMKISHOR,Rashtra Uday Party,4075,4,4079,0.37,S2449
8,JITENDRA KUMAR MAURYA,Independent,3333,3,3336,0.3,S2449
9,KULDEEP KUSHWAHA,Independent,2724,2,2726,0.25,S2449
10,RAJ BAHADUR,Peoples Party of India (Democratic),2653,1,2654,0.24,S2449
11,NIRAJ KUMAR,Akhil Bhartiya Parivar Party,2561,6,2567,0.23,S2449
12,RAM BIHARI,Bhartiya Shakti Chetna Party,2342,2,2344,0.21,S2449
13,NEERAJ LODHI,Vikas Insaf Party,2028,5,2033,0.18,S2449
14,JAY CHANDRA KUMAR,Vishwa Kalyan Rashtriya Manav Samaj Party,1602,2,1604,0.14,S2449
15,RAJESH KUMAR PATEL,Sardar Patel Siddhant Party,1449,9,1458,0.13,S2449
16,NOTA,None of the Above,8108,12,8120,0.73,S2449
1,PARSHOTTAMBHAI RUPALA,Bharatiya Janata Party,850846,7138,857984,67.37,S0610
2,DHANANI PARESH,Indian National Congress,368964,4760,373724,29.35,S0610
3,CHAMANBHAI NAGJIBHAI SAVSANI,Bahujan Samaj Party,10356,109,10465,0.82,S0610
4,AJAGIYA NIRALBHAI AMRUTLAL,Independent,3674,6,3680,0.29,S0610
5,BHAVESHBHAI KANTILAL PIPALIYA,Independent,2846,10,2856,0.22,S0610
6,BHAVESH UPENDRABHAI ACHARYA,Independent,2806,34,2840,0.22,S0610
7,PRAKASH GOVINDBHAI SINDHAV,Independent,2355,34,2389,0.19,S0610
8,ZALA NAYAN J.,Independent,2321,29,2350,0.18,S0610
9,JIGNESHBHAI MAHAJAN,Independent,1322,10,1332,0.1,S0610
10,NOTA,None of the Above,15288,634,15922,1.25,S0610
1,PARIMAL SUKLABAIDYA,Bharatiya Janata Party,647572,4833,652405,59.89,S038
2,SURYA KANTA SARKAR,Indian National Congress,386453,1641,388094,35.62,S038
3,RADHESHYAM BISWAS,All India Trinamool Congress,20384,109,20493,1.88,S038
4,RAJU DAS,Independent,4580,17,4597,0.42,S038
5,PROBASH CHANDRA SARKAR,Socialist Unity Centre Of India (COMMUNIST),4494,40,4534,0.42,S038
6,ANANTA MOHAN ROY,Independent,3113,30,3143,0.29,S038
7,RAJIB DAS,Bahujan Maha Party,1843,24,1867,0.17,S038
8,BARINDRA KUMAR DAS,Bangali Nabanirman Sena,1575,18,1593,0.15,S038
9,NOTA,None of the Above,12598,102,12700,1.17,S038
1,DR. VINOD KUMAR BIND,Bharatiya Janata Party,458877,1105,459982,42.39,S2478
2,LALITESHPATI TRIPATHI,All India Trinamool Congress,414131,1779,415910,38.33,S2478
3,HARISHANKAR,Bahujan Samaj Party,154718,335,155053,14.29,S2478
4,PREMCHAND BIND,Pragatisheel Manav Samaj Party,13655,34,13689,1.26,S2478
5,RAJ NARAYAN PATEL,Sardar Patel Siddhant Party,6198,8,6206,0.57,S2478
6,RAM PRAKASH MISHRA,Rashtriya Samaj Paksha,5266,4,5270,0.49,S2478
7,SUSHIL,All India Forward Bloc,5254,7,5261,0.48,S2478
8,DR. SHYAMDHAR TIWARI,Independent,4842,6,4848,0.45,S2478
9,KRISHNA DEV,Rashtra Uday Party,4590,7,4597,0.42,S2478
10,DHIRENDRA KUMAR TIWARI,Independent,2944,4,2948,0.27,S2478
11,NOTA,None of the Above,11222,7,11229,1.03,S2478
1,BAG MITALI,All India Trinamool Congress,710432,2155,712587,45.71,S2529
2,ARUP KANTI DIGAR,Bharatiya Janata Party,704124,2064,706188,45.3,S2529
3,BIPLAB KUMAR MOITRA,Communist Party of India  (Marxist),92073,429,92502,5.93,S2529
4,RAGHU MALLIK,Independent,16123,7,16130,1.03,S2529
5,SUBIR KUMAR ROY,Bahujan Samaj Party,3807,24,3831,0.25,S2529
6,VASKAR MALIK,Independent,3662,3,3665,0.24,S2529
7,SUKANTA POREL,Socialist Unity Centre Of India (COMMUNIST),1807,9,1816,0.12,S2529
8,BABLU GHANTI,Independent,1610,19,1629,0.1,S2529
9,ABHIJIT MAJI,Independent,1600,6,1606,0.1,S2529
10,ALOK DOLAI,Independent,1081,13,1094,0.07,S2529
11,NOTA,None of the Above,17981,50,18031,1.16,S2529
1,KAMLESH PASWAN,Bharatiya Janata Party,427528,1165,428693,45.38,S2467
2,SADAL PRASAD,Indian National Congress,423872,1671,425543,45.04,S2467
3,RAMSAMUJH,Bahujan Samaj Party,64567,183,64750,6.85,S2467
4,GAYA PRASAD,Independent,6629,9,6638,0.7,S2467
5,SHRVAN KUMAR NIRALA,Independent,4139,3,4142,0.44,S2467
6,HEERALAL,Independent,2597,0,2597,0.27,S2467
7,MURLI DHAR,Independent,1741,4,1745,0.18,S2467
8,RAJENDRA CHAUDHARI,Independent,1629,5,1634,0.17,S2467
9,NOTA,None of the Above,9006,15,9021,0.95,S2467
1,KONDA VISHWESHWAR REDDY,Bharatiya Janata Party,798517,11365,809882,48.34,S2910
2,DR GADDAM RANJITH REDDY,Indian National Congress,630861,6124,636985,38.02,S2910
3,KASANI GYANESHWAR KASANI,Bharat Rashtra Samithi,177540,1428,178968,10.68,S2910
4,RAMULU BINGI,Yuga Thulasi Party,4281,3,4284,0.26,S2910
5,KONDA VISHVESHWAR REDDY,All India Forward Bloc,3736,12,3748,0.22,S2910
6,SRIDEVI M,Alliance of Democratic Reforms Party,2684,4,2688,0.16,S2910
7,MOHAMMED SALEEM,Rashtriya Praja Congress  (Secular),2372,1,2373,0.14,S2910
8,SAHITHI DASARI,Independent,1924,14,1938,0.12,S2910
9,RANJIT REDDY GADE,Revolutionary Socialist Party,1693,5,1698,0.1,S2910
10,MOHD SHAKEEL,Desh Janhit Party,1646,1,1647,0.1,S2910
11,THOTLA RAGHAVENDER MUDIRAJ,Dharma Samaj Party,1599,49,1648,0.1,S2910
12,JANAPALA DURGA PRASAD,Independent,1516,1,1517,0.09,S2910
13,JALEEL AHMED,Independent,1508,2,1510,0.09,S2910
14,B V RAMESH NAIDU,Socialist Party (India),1494,1,1495,0.09,S2910
15,PHANI PRASAD KATAKAM,Social Justice Party of India,1425,1,1426,0.09,S2910
16,SUGURU SRINIVAS,Jai Swaraj Party,1385,1,1386,0.08,S2910
17,G MALLESHAM GOUD,Independent,1239,1,1240,0.07,S2910
18,KATHULA YADAIAH,Independent,1155,0,1155,0.07,S2910
19,DURGA PRASAD T,Praja Velugu Party,1134,5,1139,0.07,S2910
20,V PANDU,Independent,1070,5,1075,0.06,S2910
21,SANEM RAJU GOUD,Praja Ektha Party,970,1,971,0.06,S2910
22,GONE SRINIVAS REDDY,Independent,752,0,752,0.04,S2910
23,GOVIND LAL,Independent,661,0,661,0.04,S2910
24,MOHAMMED ABDUL QAVI ABBASI,All India Majlis-E-Inquilab-E-Millat,635,0,635,0.04,S2910
25,MOHAMMAD PASHA,Independent,628,0,628,0.04,S2910
26,P GOVIND,Bahujan Mukti Party,600,11,611,0.04,S2910
27,EESARI SURYAPRAKASH REDDY,Independent,581,2,583,0.03,S2910
28,SUDHAKAR VANAM,Marxist Communist Party of India (United),578,3,581,0.03,S2910
29,NARASIMHA REDDY DYAPA,Telangana Republican Party,524,1,525,0.03,S2910
30,MOHAMMED IQBAL,Independent,493,1,494,0.03,S2910
31,VISHWAKARMA SAPTHAGIRI,Independent,489,0,489,0.03,S2910
32,ANKAGALA PRAVEEN KUMAR,Independent,487,1,488,0.03,S2910
33,ANJANEYULU NEERATI,Independent,446,3,449,0.03,S2910
34,KANDIKEKAR SRINIVAS,Independent,445,1,446,0.03,S2910
35,CHINTALAGARI VENKAT SWAMY,Blue India Party,431,5,436,0.03,S2910
36,PALAMAKULA MADHU,India Praja Bandhu Party,428,2,430,0.03,S2910
37,KAVALI SUKUMAR,Independent,392,5,397,0.02,S2910
38,SERUBAI VASANTH KUMAR,Rashtra Samanya Praja Party,311,1,312,0.02,S2910
39,MOHAMMED MUSTAFA RIZWAN,Independent,300,1,301,0.02,S2910
40,MOHAMMAD RIAZUR REHMAN SHAIK,Independent,283,2,285,0.02,S2910
41,MOHAMMED ALI,Independent,247,1,248,0.01,S2910
42,AMIR SAJID,Independent,226,2,228,0.01,S2910
43,MOHAMMED AFSAR QUDOOS,Independent,179,0,179,0.01,S2910
44,NOTA,None of the Above,6313,110,6423,0.38,S2910
1,MATHESWARAN V S,Dravida Munnetra Kazhagam,457695,4341,462036,40.31,S2216
2,TAMILMANI S,All India Anna Dravida Munnetra Kazhagam,429358,3566,432924,37.77,S2216
3,DR RAMALINGAM K P,Bharatiya Janata Party,103577,1113,104690,9.13,S2216
4,KANIMOZHI G,Naam Tamilar Katchi,94895,682,95577,8.34,S2216
5,DEEPAN CHAKKRAVARTHI S,Independent,3546,33,3579,0.31,S2216
6,RAJENDRAN C,Viduthalai Kalam Katchi,2592,7,2599,0.23,S2216
7,NATARAJAN M,Independent,2565,23,2588,0.23,S2216
8,RAMESH T,Ahimsa Socialist Party,2412,9,2421,0.21,S2216
9,EZHIL SELVAN P,Tamilaga Makkal Thannurimai Katchi,2149,16,2165,0.19,S2216
10,RAMAN V,Bahujan Samaj Party,2137,20,2157,0.19,S2216
11,UTHAYAKUMAR P,Independent,1899,2,1901,0.17,S2216
12,KANDASAMY A M,Independent,1510,4,1514,0.13,S2216
13,RAMASAMY P,Independent,1338,12,1350,0.12,S2216
14,KARTHI S,Independent,1332,2,1334,0.12,S2216
15,RAMESH T R,Independent,1317,8,1325,0.12,S2216
16,SATHEESH G,Independent,1284,8,1292,0.11,S2216
17,RAMASAMY N,Independent,1243,7,1250,0.11,S2216
18,MADHESWARAN V,Independent,1144,3,1147,0.1,S2216
19,DR GURUNATHAN S,Independent,1048,23,1071,0.09,S2216
20,KARTHIKEYAN S,Independent,918,2,920,0.08,S2216
21,NALLATHAMBI P,Independent,769,1,770,0.07,S2216
22,EASWARAMOORTHY M,Independent,758,10,768,0.07,S2216
23,BALAJICHEZHIAN P,Independent,716,3,719,0.06,S2216
24,RAVIKUMAR P,Ganasangam Party of India,633,4,637,0.06,S2216
25,NAVEEN K,Independent,633,2,635,0.06,S2216
26,DURAIRAJ C,Independent,590,2,592,0.05,S2216
27,ARULMANI M,Independent,564,4,568,0.05,S2216
28,THIYAGARAJAN R,Samaniya Makkal Nala Katchi,527,1,528,0.05,S2216
29,VENNILA S,Independent,520,8,528,0.05,S2216
30,KALIANNAN S,Independent,496,1,497,0.04,S2216
31,KANDASAMY P,Independent,475,5,480,0.04,S2216
32,MANIKKAM S,Ulzaipali Makkal Katchy,439,3,442,0.04,S2216
33,MOORTHI J,Independent,385,4,389,0.03,S2216
34,TAMILMANI A,Independent,352,2,354,0.03,S2216
35,SELVARAJ K R,Independent,301,2,303,0.03,S2216
36,SAKTHIVEL S,Independent,298,1,299,0.03,S2216
37,NETAJIKAVIARASU V,Independent,287,1,288,0.03,S2216
38,SIVAKUMAR V,Independent,244,2,246,0.02,S2216
39,MOORTHY V,Independent,220,2,222,0.02,S2216
40,GOPAL P,Independent,214,0,214,0.02,S2216
41,NOTA,None of the Above,12736,248,12984,1.13,S2216
1,ABDUL RASHID SHEIKH,Independent,469574,2907,472481,45.7,U081
2,OMAR ABDULLAH,Jammu & Kashmir National Conference,266301,2038,268339,25.95,U081
3,SAJAD GANI LONE,Jammu & Kashmir People Conference,171582,1657,173239,16.76,U081
4,MIR MOHAMMAD FAYAZ,Jammu & Kashmir Peoples Democratic Party,27173,315,27488,2.66,U081
5,SURAIYA NISSAR,Independent,21565,53,21618,2.09,U081
6,FIRDOUS AHMAD BHAT,Independent,15707,15,15722,1.52,U081
7,SHAFEEQA BEGUM,Independent,6203,11,6214,0.6,U081
8,PEERZADA MUDASIR RASHID SHAH,Jammu & Kashmir National Panthers Party (Bhim),5499,67,5566,0.54,U081
9,KHURSHEED AHMAD SHAH,Rashtriya Jankranti Party,4213,55,4268,0.41,U081
10,MOHAMMAD SULTAN GANAIE,Independent,4054,9,4063,0.39,U081
11,SHADIB HANIEF KHAN,Independent,3668,2,3670,0.35,U081
12,MUDASIR AHMAD TANTARY,Independent,3196,22,3218,0.31,U081
13,NAZIR AHMAD SOFI,Independent,2980,3,2983,0.29,U081
14,SHABIR AHMAD DAR,Independent,2694,6,2700,0.26,U081
15,HILAL AHMAD WAGAY,Independent,2681,8,2689,0.26,U081
16,MEHRAJ UDDIN NAJAR,Independent,2560,10,2570,0.25,U081
17,SYED AMEER SUHAIL,Independent,2409,8,2417,0.23,U081
18,FAROOQ AHMAD BHAT,National Youth Party,2315,28,2343,0.23,U081
19,ARUN KUMAR RAINA,Independent,2161,80,2241,0.22,U081
20,MUNIR AHMAD KHAN,Jammu and Kashmir Nationalist People's Front,2004,15,2019,0.2,U081
21,MUZAFFAR HUSSAIN DAR,Independent,1663,8,1671,0.16,U081
22,MUSHTAQ AHMAD MIR,National Loktantrik Party,1382,15,1397,0.14,U081
23,NOTA,None of the Above,4873,111,4984,0.48,U081
1,NARAYAN DAS AHIRWAR,Samajwadi Party,529444,736,530180,46.96,S2445
2,BHANU PRATAP SINGH VERMA,Bharatiya Janata Party,475232,1050,476282,42.19,S2445
3,SURESH CHANDRA GAUTAM,Bahujan Samaj Party,100105,143,100248,8.88,S2445
4,BRIJ MOHAN,Independent,4666,7,4673,0.41,S2445
5,NAGENDRA KUMAR,Bhartiya Shakti Chetna Party,3205,7,3212,0.28,S2445
6,PREMLATA VERMA,Independent,3176,24,3200,0.28,S2445
7,NOTA,None of the Above,11138,16,11154,0.99,S2445
1,BHOJRAJ NAG,Bharatiya Janata Party,595185,2439,597624,47.23,S2611
2,BIRESH THAKUR,Indian National Congress,593268,2472,595740,47.08,S2611
3,TILAK RAM MARKAM,Bahujan Samaj Party,11694,76,11770,0.93,S2611
4,SONSINGH,Ambedkarite Party of India,11351,11,11362,0.9,S2611
5,JIVAN LAL MATLAM,Sarv Adi Dal,8935,14,8949,0.71,S2611
6,SUKCHAND NETAM,Gondvana Gantantra Party,8617,106,8723,0.69,S2611
7,VINOD NAGWANSHI,Hamar Raj Party,4958,51,5009,0.4,S2611
8,THAKESH MAHLA,Bhartiya Shakti Chetna Party,4201,21,4222,0.33,S2611
9,BHOJRAM MANDAVI,Rashtriya Jansabha Party,3326,35,3361,0.27,S2611
10,NOTA,None of the Above,18618,51,18669,1.48,S2611
1,KARTI P CHIDAMBARAM,Indian National Congress,425631,2046,427677,40.6,S2231
2,XAVIERDASS A,All India Anna Dravida Munnetra Kazhagam,221255,758,222013,21.08,S2231
3,DHEVANATHAN YADAV T,Bharatiya Janata Party,194559,1229,195788,18.59,S2231
4,EZHILARASI,Naam Tamilar Katchi,162558,854,163412,15.51,S2231
5,DHANALAKSHMI M,Independent,8494,18,8512,0.81,S2231
6,GOVINDHARAJU M.G,Independent,4231,10,4241,0.4,S2231
7,NAGARAJAN  KR,Independent,3682,14,3696,0.35,S2231
8,PALANIYAPPAN  R,Independent,3426,1,3427,0.33,S2231
9,RANJITHKUMAR BALUSWAMY,Bahujan Samaj Party,3160,11,3171,0.3,S2231
10,BASKARAN S,Independent,2191,3,2194,0.21,S2231
11,KALAISELVAM K,Independent,1660,3,1663,0.16,S2231
12,MALAISAMY K,Independent,1524,3,1527,0.14,S2231
13,SEKAR  A,Independent,1285,7,1292,0.12,S2231
14,SELVARAJ P,Independent,1108,3,1111,0.11,S2231
15,THILLAIVASAGAM   M,Vidiyalai Thedum Indhiyargal Party,1068,5,1073,0.1,S2231
16,ASHOK KUMAR K,Independent,1030,4,1034,0.1,S2231
17,KARTHICK  C,Independent,975,6,981,0.09,S2231
18,MUTHARASU PANDIYAN  V,Independent,824,4,828,0.08,S2231
19,KALAIRAJA  B,Independent,816,3,819,0.08,S2231
20,KARTHIKAIRAJAN  P,Independent,762,9,771,0.07,S2231
21,NOTA,None of the Above,8119,70,8189,0.78,S2231
1,KRITI DEVI DEBBARMAN,Bharatiya Janata Party,768129,9318,777447,68.54,S232
2,RAJENDRA REANG,Communist Party of India  (Marxist),287772,2856,290628,25.62,S232
3,ARCHANA URANG,Independent,10814,108,10922,0.96,S232
4,DARSHAN KUMAR REANG,Independent,9200,69,9269,0.82,S232
5,SANTOJOY TRIPURA,Independent,6825,37,6862,0.6,S232
6,SHIB CHANDRA DEBBARMA,Independent,6685,34,6719,0.59,S232
7,SATRUGHNA JAMATIA,Independent,5939,28,5967,0.53,S232
8,KRISHNA MOHAN JAMATIA,Independent,4166,51,4217,0.37,S232
9,KALPA MOHAN TRIPURA,Independent,3958,53,4011,0.35,S232
10,NOTA,None of the Above,18176,127,18303,1.61,S232
1,HASMUKHBHAI PATEL (H.S.PATEL),Bharatiya Janata Party,763028,7431,770459,68.28,S067
2,HIMMATSINH PRAHLADSINH PATEL,Indian National Congress,303713,4991,308704,27.36,S067
3,MAKWANA JAYANTIBHAI KANJIBHAI,Bahujan Samaj Party,10235,247,10482,0.93,S067
4,BRIJESH SHARMA,Independent,4514,12,4526,0.4,S067
5,HARSHAD BABUBHAI NANDOLIYA,Independent,3554,17,3571,0.32,S067
6,MAHESHKUMAR SOMABHAI THAKOR,Independent,3005,28,3033,0.27,S067
7,KALPESHBHAI  SHETE,Gunj Satya Ni Janata Party,2927,10,2937,0.26,S067
8,PATANI VISHNUBHAI NATAVARBHAI,Independent,2377,43,2420,0.21,S067
9,ZALA SANJAYKUMAR MAHOBATSINH,Independent,2310,56,2366,0.21,S067
10,DASHARATHBHAI KANTILAL PANCHAL,Independent,1474,6,1480,0.13,S067
11,PRAMOD SAHDEVBHAI GUDADE,Swatantrata Abhivyakti Party,1275,4,1279,0.11,S067
12,RAJESH HARIRAM MAURYA,Prajatantra Aadhar Party,1199,13,1212,0.11,S067
13,INGOLE ROOPESHBHAI BABUBHAI,Independent,1153,16,1169,0.1,S067
14,DHANANJAY GIRJASHANKAR RAJPUT,Bhartiya Jan Parishad,1083,37,1120,0.1,S067
15,MANISH KUMAR DUBEY,Swaraj Kranti Party,898,11,909,0.08,S067
16,CHAUHAN MOHAMADFARUK  AHEMADHASANBHAI,Independent,771,7,778,0.07,S067
17,HITENDRABHAI PATEL,Aadi Bharat Party,722,20,742,0.07,S067
18,PIYUSHBHAI BHAVSAR,Youth India Peace Party,642,7,649,0.06,S067
19,NOTA,None of the Above,9911,592,10503,0.93,S067
1,SHASHANK MANI,Bharatiya Janata Party,503509,1032,504541,48.36,S2466
2,AKHILESH PRATAP SINGH,Indian National Congress,467946,1753,469699,45.02,S2466
3,SANDESH,Bahujan Samaj Party,45446,118,45564,4.37,S2466
4,SATENDER KUMAR MALL,Independent,4149,9,4158,0.4,S2466
5,MUKTINATH SINGH,Janta Samta Party,3261,3,3264,0.31,S2466
6,AGAMSWAROOP,Rashtriya Samanta Dal,3180,2,3182,0.3,S2466
7,RAFIK ANSARI,Independent,2687,1,2688,0.26,S2466
8,NOTA,None of the Above,10203,9,10212,0.98,S2466
1,RAMVIR SINGH BIDHURI,Bharatiya Janata Party,691184,1648,692832,53.46,U057
2,SAHI RAM,Aam Aadmi Party,567716,783,568499,43.87,U057
3,ABDUL BASIT,Bahujan Samaj Party,9829,32,9861,0.76,U057
4,RAM GOPAL,Haryana Jansena Party,3956,2,3958,0.31,U057
5,CHANDRASHEKHAR SINGH KUSHWAHA,Independent,1888,1,1889,0.15,U057
6,DEEPAK KAPILA,Independent,1500,0,1500,0.12,U057
7,OMAPRAKASH,Samaj Vikas Kranti Party,1364,1,1365,0.11,U057
8,JAGDISH KUMAR VERMA,Independent,1295,1,1296,0.1,U057
9,LAKHAN SINGH,Navarang Congress Party,967,3,970,0.07,U057
10,POONAM SRIVASTAVA,Independent,951,7,958,0.07,U057
11,ARUN KUMAR,Independent,842,0,842,0.06,U057
12,RINKI SANYAL,Bharatiya Sampuran Krantikari Party,762,1,763,0.06,U057
13,KAMLESH KUMAR JHA,Independent,714,0,714,0.06,U057
14,SURJEET SINGH,Delhi Janta Party,637,1,638,0.05,U057
15,BHIM SINGH,Ambedkarite Party of India,601,1,602,0.05,U057
16,SURINDER KUMAR,Bharatheeya Jawan Kisan Party,592,0,592,0.05,U057
17,GAUTAM ANAND,All India Forward Bloc,539,1,540,0.04,U057
18,SHANKAR DEY,Independent,522,0,522,0.04,U057
19,BIHARI LAL JALANDHARI,India Greens Party,511,3,514,0.04,U057
20,NAVEEN KUMAR,Hamara Sahi Vikalp Party,475,1,476,0.04,U057
21,VIRENDER,Independent,381,0,381,0.03,U057
22,RAJAN SINGH,Independent,323,2,325,0.03,U057
23,NOTA,None of the Above,5927,34,5961,0.46,U057
1,GURJEET SINGH AUJLA,Indian National Congress,254414,767,255181,28.18,S192
2,KULDEEP SINGH DHALIWAL,Aam Aadmi Party,214268,612,214880,23.73,S192
3,TARANJIT SINGH SANDHU SAMUNDRI,Bharatiya Janata Party,206832,373,207205,22.88,S192
4,ANIL JOSHI,Shiromani Akali Dal,162686,210,162896,17.99,S192
5,EMAAN SINGH MANN,Shiromani Akali Dal (Amritsar)(Simranjit Singh Mann),26584,212,26796,2.96,S192
6,SATBIR SINGH  JAMMU,Independent,3394,5,3399,0.38,S192
7,VISHAL SIDHU,Bahujan Samaj Party,2713,20,2733,0.3,S192
8,DASWINDER KAUR,Communist Party of India,2468,13,2481,0.27,S192
9,SHARANJIT KAUR,Independent,2456,4,2460,0.27,S192
10,AMANPREET SINGH MAHADIPUR,Independent,2353,9,2362,0.26,S192
11,GURINDER SINGH SABHI GILL,Independent,2124,5,2129,0.24,S192
12,SAHIB SINGH,Independent,1987,1,1988,0.22,S192
13,SHAMSHER SINGH SHERA,Independent,1504,3,1507,0.17,S192
14,SHAM LAL GANDHI,Independent,1487,0,1487,0.16,S192
15,LOVEPREET SHARMA,Aas Punjab Party,1372,3,1375,0.15,S192
16,MASTER HARJINDER PAL,Independent,1358,0,1358,0.15,S192
17,JASPAL MASIH,Independent,1223,4,1227,0.14,S192
18,RESHAM SINGH,Independent,1130,3,1133,0.13,S192
19,BAL KRISHAN SHARMA,Independent,1106,1,1107,0.12,S192
20,SIMRANPREET SINGH,Independent,1104,2,1106,0.12,S192
21,NARINDER KAUR,Aam Janta Party (India),1064,33,1097,0.12,S192
22,DILDAR MASIH,Shiromani Lok Dal Party,1042,2,1044,0.12,S192
23,RAJINDER KUMAR SHARMA,Independent,899,1,900,0.1,S192
24,BALWINDER SINGH,Independent,854,3,857,0.09,S192
25,GURPREET SINGH RATTAN,Republican Party of India (Athawale),735,3,738,0.08,S192
26,DR RAMESH KUMAR,Sacho Sach Party,650,2,652,0.07,S192
27,GAGANDEEP,Independent,608,2,610,0.07,S192
28,PRITHVI PAL,Independent,434,0,434,0.05,S192
29,NEELAM,Independent,404,5,409,0.05,S192
30,DILBAGH SINGH,Independent,388,3,391,0.04,S192
31,NOTA,None of the Above,3685,29,3714,0.41,S192
1,MANI. A.,Dravida Munnetra Kazhagam,429301,3366,432667,34.67,S2210
2,SOWMIYA ANBUMANI,Pattali Makkal Katchi,408445,2922,411367,32.97,S2210
3,ASOKAN. R. DR.,All India Anna Dravida Munnetra Kazhagam,291590,2039,293629,23.53,S2210
4,ABINAYA,Naam Tamilar Katchi,64576,805,65381,5.24,S2210
5,THANGAVEL. K.,Dhesiya Makkal Kazhagam,7323,8,7331,0.59,S2210
6,THIRUMURUGAN. P.,Independent,5668,3,5671,0.45,S2210
7,HARI. R.,Bahujan Samaj Party,3128,38,3166,0.25,S2210
8,SOWMIYA,Independent,3001,27,3028,0.24,S2210
9,ELAYARANI. P.,Ganasangam Party of India,2301,14,2315,0.19,S2210
10,ARUMUGAM. M.,Independent,2274,16,2290,0.18,S2210
11,AGNI AALVAR,Independent,1643,8,1651,0.13,S2210
12,PALANI. K.,Independent,1441,9,1450,0.12,S2210
13,MANI. R.,Independent,1029,4,1033,0.08,S2210
14,ASHOKAN. M.,Independent,1024,2,1026,0.08,S2210
15,ALAGARASAN. R.,Independent,899,1,900,0.07,S2210
16,SUNDHARAMOORTHY. M.,Independent,797,3,800,0.06,S2210
17,MANI. C.,Independent,706,4,710,0.06,S2210
18,PARTHASARATHI,Tamilar Makkal Katchi,698,11,709,0.06,S2210
19,PADMARAJAN. K. DR.,Independent,649,8,657,0.05,S2210
20,MANIVASAGAM. C.,Independent,648,3,651,0.05,S2210
21,ASOKAN. G.,Independent,609,2,611,0.05,S2210
22,AYYAKANNU,Independent,583,3,586,0.05,S2210
23,JAGANATHAN. A.,Independent,551,2,553,0.04,S2210
24,MANI. S.,Independent,451,1,452,0.04,S2210
25,NOTA,None of the Above,9093,105,9198,0.74,S2210
1,RACHNA BANERJEE,All India Trinamool Congress,700120,2624,702744,46.31,S2528
2,LOCKET CHATTERJEE,Bharatiya Janata Party,623867,2024,625891,41.24,S2528
3,MANADIP GHOSH,Communist Party of India  (Marxist),139250,669,139919,9.22,S2528
4,SURAJIT HEMBRAM,Independent,9257,11,9268,0.61,S2528
5,SAMIM ALI MOLLICK,Independent,6555,12,6567,0.43,S2528
6,JAMINI BHAR,Bahujan Samaj Party,4684,34,4718,0.31,S2528
7,AJANTA SARKAR,Bharatiya National Janata Dal,3619,20,3639,0.24,S2528
8,SK KAMALUDDIN,Independent,2755,11,2766,0.18,S2528
9,SANCHITA BERA,Independent,2632,17,2649,0.17,S2528
10,PABAN MAZUMDER,Socialist Unity Centre Of India (COMMUNIST),2367,13,2380,0.16,S2528
11,PRADIP PAL,Bharatiya Nyay-Adhikar Raksha Party,2205,15,2220,0.15,S2528
12,MRINAL KANTI DAS,Independent,1387,11,1398,0.09,S2528
13,NOTA,None of the Above,13250,102,13352,0.88,S2528
1,DHAVAL LAXMANBHAI  PATEL,Bharatiya Janata Party,760935,3291,764226,56.13,S0626
2,ANANTKUMAR HASMUKHBHAI PATEL,Indian National Congress,547307,6215,553522,40.66,S0626
3,MANAKBHAI JATRUBHAI SHANKAR,Bahujan Samaj Party,7487,12,7499,0.55,S0626
4,RAMANBHAI KARSHANBHAI PATEL,Independent,6732,13,6745,0.5,S0626
5,JAYANTIBHAI KHANDUBHAI SHALUA,Viro Ke Vir Indian Party,4763,11,4774,0.35,S0626
6,CHIRAGKUMAR BHARATBHAI  PATEL,Independent,3431,9,3440,0.25,S0626
7,UMESHBHAI MAGANBHAI PATEL,Bahujan Republican  Socialist Party,2813,19,2832,0.21,S0626
8,NOTA,None of the Above,18169,204,18373,1.35,S0626
1,ANOOP PRADHAN BALMIKI,Bharatiya Janata Party,552334,2412,554746,51.24,S2416
2,JASVEER VALMIKI,Samajwadi Party,306637,791,307428,28.39,S2416
3,HEMBABOO DHANGAR,Bahujan Samaj Party,200876,387,201263,18.59,S2416
4,JAYPAL MAHOR,Independent,3044,17,3061,0.28,S2416
5,RAJPAL SINGH,Independent,2361,11,2372,0.22,S2416
6,GHANSHYAM SINGH,Swaraj Bhartiya Nyay Party,2329,16,2345,0.22,S2416
7,RAVI KUMAR,Independent,1638,7,1645,0.15,S2416
8,DR. JAYVEER SINGH DHANGAR,Rashtra Uday Party,1591,16,1607,0.15,S2416
9,DINESH SAI,Independent,1140,4,1144,0.11,S2416
10,MUNNALAL JATAV,Independent,803,7,810,0.07,S2416
11,NOTA,None of the Above,6257,42,6299,0.58,S2416
1,DABHI  BHARATSINHJI  SHANKARJI,Bharatiya Janata Party,585591,6356,591947,49.61,S063
2,CHANDANJI TALAJI THAKOR,Indian National Congress,555134,4937,560071,46.94,S063
3,BALVANT CHHATRALIYA,Bahujan Samaj Party,5811,54,5865,0.49,S063
4,SOYAB HASAM BHORANIYA,Independent,5473,1,5474,0.46,S063
5,THAKOR KISHANBHAI KALUBHAI,Independent,2909,7,2916,0.24,S063
6,SHARMA RAKESHBHAI,Rashtriya Samaj Paksha,2765,9,2774,0.23,S063
7,GHAGHA MASIHULLAH ABDULHAMID,Social Democratic Party Of India,2305,7,2312,0.19,S063
8,CHANDURA DHANJIBHAI LAXAMANBHAI,Independent,2135,25,2160,0.18,S063
9,ABDULHAQ ISMAIL NEDARIYA,Independent,1510,14,1524,0.13,S063
10,ABDULKUDDUS,Independent,1358,2,1360,0.11,S063
11,NOTA,None of the Above,16382,340,16722,1.4,S063
1,M. K. RAGHAVAN,Indian National Congress,515608,4813,520421,47.74,S115
2,ELAMARAM KAREEM,Communist Party of India  (Marxist),369884,4361,374245,34.33,S115
3,M. T. RAMESH,Bharatiya Janata Party,178692,1974,180666,16.57,S115
4,ARAMUKHAN,Bahujan Samaj Party,1684,31,1715,0.16,S115
5,ARAVINDAKSHAN NAIR M. K.,Bharatheeya Jawan Kisan Party,1290,15,1305,0.12,S115
6,RAGHAVAN S/O NARAYANAN NAIR,Independent,1057,39,1096,0.1,S115
7,T. RAGHAVAN S/O VELLANKUTTY,Independent,1009,9,1018,0.09,S115
8,N. RAGHAVAN S/O DAMU,Independent,753,29,782,0.07,S115
9,SUBHA,Independent,705,7,712,0.07,S115
10,DR. M. JYOTHIRAJ,Socialist Unity Centre Of India (COMMUNIST),641,12,653,0.06,S115
11,ABDUL KAREEM S/O MAHAMMOOD,Independent,536,5,541,0.05,S115
12,ABDUL KAREEM S/O AYAMMATH KUTTY,Independent,285,2,287,0.03,S115
13,ABDUL KAREEM K. S/O ASSAIN,Independent,257,36,293,0.03,S115
14,NOTA,None of the Above,6236,80,6316,0.58,S115
1,ANITA SUBHADARSHINI,Bharatiya Janata Party,493032,1194,494226,48.55,S1819
2,RANJITA SAHU,Biju Janata Dal,393759,493,394252,38.73,S1819
3,DEBAKANTA SARMA,Indian National Congress,75108,147,75255,7.39,S1819
4,SANJAYA KUMAR BISHOYI,Independent,11234,6,11240,1.1,S1819
5,PAPUNU SAHU,Socialist Unity Centre Of India (COMMUNIST),8671,2,8673,0.85,S1819
6,PITABAS SAHU,Sanatan Sanskriti Raksha Dal,6888,0,6888,0.68,S1819
7,BRUNDABANA NAHAK,Bahujan Samaj Party,5430,9,5439,0.53,S1819
8,NOTA,None of the Above,21925,16,21941,2.16,S1819
1,BHUPATHI RAJU SRINIVASA VARMA (B.J.P.VARMA),Bharatiya Janata Party,699382,7961,707343,57.46,S019
2,UMABALA GUDURI,Yuvajana Sramika Rythu Congress Party,426037,4504,430541,34.98,S019
3,K.B.R.NAIDU,Indian National Congress,34298,915,35213,2.86,S019
4,PRASANNA KUMAR UNDURTHI,Independent,6350,14,6364,0.52,S019
5,MEDAPATI VENKATA VARAHALA REDDY,Independent,5966,3,5969,0.48,S019
6,SIRRA RAJU,Bahujan Samaj Party,5945,69,6014,0.49,S019
7,BALAGAM NAYAKAR,Independent,5232,8,5240,0.43,S019
8,NALLI RAJESH,Independent,4684,0,4684,0.38,S019
9,KETHA SREENU,Independent,3140,5,3145,0.26,S019
10,OLETY NAGENDRA KRISHNA,Jaibhim Rao Bharat Party,3112,4,3116,0.25,S019
11,ADDEPALLI VEERA VENKAT SUBBA RAO,Independent,2781,2,2783,0.23,S019
12,ANAND CHANDULAL JASTI,Independent,2726,0,2726,0.22,S019
13,GANJI PURNIMA,Republican Party of India (A),1645,4,1649,0.13,S019
14,GEDALA LAXMANA RAO,Independent,1525,2,1527,0.12,S019
15,ADDANKI DORABABU,Independent,1388,5,1393,0.11,S019
16,GOTTUMUKKALA SHIVAJI,Independent,1378,6,1384,0.11,S019
17,ADINARAYANA DUPPANAPUDI,Independent,1002,5,1007,0.08,S019
18,MANNE LEELA RAMA NARENDRA,Pyramid Party of India,922,8,930,0.08,S019
19,RAMA DURGA PRASAD THOLETI,Independent,919,1,920,0.07,S019
20,RUKHMINI,Independent,683,3,686,0.06,S019
21,ADABALA SIVA,Independent,682,1,683,0.06,S019
22,NOTA,None of the Above,7554,123,7677,0.62,S019
1,JITENDRA KUMAR DOHARE,Samajwadi Party,489358,1389,490747,47.47,S2441
2,DR RAM SHANKAR KATHERIA,Bharatiya Janata Party,430922,1406,432328,41.82,S2441
3,SARIKA SINGH BAGHEL,Bahujan Samaj Party,96253,288,96541,9.34,S2441
4,SUNIL SHANKWAR ADVOCATE,Independent,2954,9,2963,0.29,S2441
5,MULAYAM SINGH,Independent,1688,20,1708,0.17,S2441
6,BHUVNESH KUMARI,Samyak Party,1648,9,1657,0.16,S2441
7,VIVEK RAJ,Janta Samajwadi Party (Vivek Raj),1569,5,1574,0.15,S2441
8,NOTA,None of the Above,6229,37,6266,0.61,S2441
1,KRISHNA DEVI SHIVSHANKER PATEL,Samajwadi Party,406018,549,406567,38.94,S2448
2,R. K. SINGH PATEL,Bharatiya Janata Party,334950,407,335357,32.12,S2448
3,MAYANK DWIVEDI,Bahujan Samaj Party,245530,215,245745,23.54,S2448
4,RAMCHANDRA SARAS,Communist Party of India,9436,2,9438,0.9,S2448
5,PANCHA URF PANCHAMLAL,Bhagidari Party(P),7714,3,7717,0.74,S2448
6,GULAB CHANDER BARMA,Rashtra Uday Party,5905,2,5907,0.57,S2448
7,RAMCHRAN,Independent,5419,4,5423,0.52,S2448
8,SURENDRA KUMAR,Swatantra Jantaraj Party,4380,2,4382,0.42,S2448
9,SHRIRAM SINGH GAUR,Bhartiya Shakti Chetna Party,3347,3,3350,0.32,S2448
10,DINESH KUMAR PATEL,Sardar Patel Siddhant Party,2507,1,2508,0.24,S2448
11,BABULAL,Log Party,2358,3,2361,0.23,S2448
12,PRAMOD AZAD,Apna Dal (Kamerawadi),2141,1,2142,0.21,S2448
13,NOTA,None of the Above,13226,9,13235,1.27,S2448
1,VIJAY KUMAR DUBAY,Bharatiya Janata Party,516006,339,516345,47.79,S2465
2,AJAY PRATAP SINGH URF PINTU SAITHWAR,Samajwadi Party,434210,345,434555,40.22,S2465
3,SUBH NARAYAN CHAUHAN,Bahujan Samaj Party,67155,53,67208,6.22,S2465
4,SWAMI PRASAD MAURYA,Rashtriya Shoshit Samaj Party,36559,16,36575,3.39,S2465
5,HARIKESH,Azad Adhikar Sena,4094,3,4097,0.38,S2465
6,RAMCHANDRA SINGH,Independent,3619,2,3621,0.34,S2465
7,SUNIL KUMAR SHUKLA,Bhartiya Lok Nayak Party,3529,3,3532,0.33,S2465
8,AMIY UPADHYAY,Independent,2432,1,2433,0.23,S2465
9,VEDPRAKASH MISHRA,Subhashwadi Bhartiya Samajwadi Party (Subhas Party),2332,3,2335,0.22,S2465
10,NOTA,None of the Above,9774,8,9782,0.91,S2465
1,BACHHAV SHOBHA DINESH,Indian National Congress,582492,1374,583866,47.89,S132
2,BHAMRE SUBHASH RAMRAO,Bharatiya Janata Party,577778,2257,580035,47.57,S132
3,BHARAT BABURAO JADHAV,Independent,19695,18,19713,1.62,S132
4,ZAHOOR AHAMAD MOHAMAD YUSUF (JAM JAM),Bahujan Samaj Party,4955,18,4973,0.41,S132
5,SANJAY RAMESHWAR SHARMA,Independent,3741,5,3746,0.31,S132
6,SHAFEEQUE AHEMAD MD. RAFEEQUE,Independent,3706,1,3707,0.3,S132
7,NAMDEO ROHIDAS YELAVE,Bharatheeya Jawan Kisan Party,3659,24,3683,0.3,S132
8,ADV SACHIN UMAJI NIKAM,Independent,3657,3,3660,0.3,S132
9,RAJ CHAVAN,Independent,3443,9,3452,0.28,S132
10,MOHAMMAD ISMAIL JUMMAN,Independent,1084,1,1085,0.09,S132
11,SURESH JAGANNATH BRAHMANKAR (SURESH BAPU),Independent,1035,3,1038,0.09,S132
12,PATIL SHIVAJI NATHU,All India Forward Bloc,994,7,1001,0.08,S132
13,SHAIKH MOHAMMAD ZAID SHAMIM AHMED,Welfare Party Of India,946,5,951,0.08,S132
14,MOHAMMAD AAMEEN MOHAMMAD FARUQUE,Independent,833,2,835,0.07,S132
15,MUQEEM MEENA NAGRI,Bhim Sena,773,8,781,0.06,S132
16,IRFAN. MO. ISHAK (NADIR),Independent,763,0,763,0.06,S132
17,MALAY PRAKASH PATIL,Independent,734,2,736,0.06,S132
18,ABDUL HAFEEZ ABDUL HAQUE,Independent,576,1,577,0.05,S132
19,NOTA,None of the Above,4661,32,4693,0.38,S132
1,SWAMI SACHCHIDANAND HARI SAKSHI,Bharatiya Janata Party,614832,1301,616133,47.31,S2433
2,ANNU TANDON,Samajwadi Party,577699,2616,580315,44.56,S2433
3,ASHOK KUMAR PANDEY,Bahujan Samaj Party,72245,282,72527,5.57,S2433
4,SAIF KHAN,Parcham Party of India,8390,14,8404,0.65,S2433
5,UMESH,Independent,5625,10,5635,0.43,S2433
6,SHIV PRAKASH SINGH,Independent,4107,11,4118,0.32,S2433
7,SAIYYAD SARFARAZ GANDHI,Independent,3018,5,3023,0.23,S2433
8,HIMANSHU SHARMA,Bhartiya Shakti Chetna Party,2656,7,2663,0.2,S2433
9,NOTA,None of the Above,9430,23,9453,0.73,S2433
1,RAJ NATH SINGH,Bharatiya Janata Party,610597,2112,612709,53.89,S2435
2,RAVIDAS MEHROTRA,Samajwadi Party,476303,1247,477550,42,S2435
3,MOHAMMAD SARWAR MALIK,Bahujan Samaj Party,29982,210,30192,2.66,S2435
4,MO AHMAD URF RINKU,Social Democratic Party Of India,3251,4,3255,0.29,S2435
5,AKHAND PRATAP SINGH,Independent,1465,8,1473,0.13,S2435
6,SARVAR ALI,Sarvar Party,1199,3,1202,0.11,S2435
7,ISHTIYAQ ALI,Independent,929,5,934,0.08,S2435
8,KAPIL MOHAN CHOWDHARY,Mera Adhikaar Rashtriya Dal,815,2,817,0.07,S2435
9,GAURAV VERMA,Hindu Samaj Party,801,6,807,0.07,S2435
10,BRIJESH KUMAR YADAV,Kisan Vishwa Party,601,2,603,0.05,S2435
11,NOTA,None of the Above,7316,34,7350,0.65,S2435
1,GAURAV GOGOI,Indian National Congress,743194,8577,751771,54.04,S0314
2,TOPON KUMAR GOGOI,Bharatiya Janata Party,602019,5359,607378,43.66,S0314
3,ARUN CHANDRA HANDIQUE,Ekam Sanatan Bharat Dal,8998,88,9086,0.65,S0314
4,RAJ KUMAR DUWARA,Independent,8315,55,8370,0.6,S0314
5,NOTA,None of the Above,14477,78,14555,1.05,S0314
1,MOHIBBULLAH,Samajwadi Party,481252,251,481503,49.74,S247
2,GHANSHYAM SINGH LODHI,Bharatiya Janata Party,393154,915,394069,40.71,S247
3,ZEESHAN KHAN,Bahujan Samaj Party,79561,131,79692,8.23,S247
4,ARSHAD WARSI,Minorities Democratic Party,2919,8,2927,0.3,S247
5,MEHMOOD PRACHA,Independent,2750,9,2759,0.28,S247
6,SHIV PRASAD,Independent,1465,11,1476,0.15,S247
7,NOTA,None of the Above,5643,10,5653,0.58,S247
1,DR. KALGE SHIVAJI BANDAPPA,Indian National Congress,607030,1991,609021,49.15,S1341
2,SUDHAKAR TUKARAM SHRANGARE,Bharatiya Janata Party,545240,1900,547140,44.16,S1341
3,NARSINGRAO UDGIRKAR,Vanchit Bahujan  Aaghadi,42104,121,42225,3.41,S1341
4,ATITHI KHANDERAO SURYVANSHI,Swarajya Shakti Sena,5150,28,5178,0.42,S1341
5,ALTE VISHWANATH MAHADEV,Bahujan Samaj Party,5081,40,5121,0.41,S1341
6,KAMANT MACHHINDRA GUNWANTRAO,Bahujan Bharat Party,2249,20,2269,0.18,S1341
7,ABHANG GANGARAM SURYAWANSHI,Independent,2102,0,2102,0.17,S1341
8,DATTU SOPAN NARSINGE,Independent,2000,2,2002,0.16,S1341
9,DEEPAK KEDAR,Independent,1712,14,1726,0.14,S1341
10,UMESH AMBADAS KAMBLE,Independent,1683,8,1691,0.14,S1341
11,BANSODE RAGHUNATH WAGHOJI,Independent,1596,4,1600,0.13,S1341
12,BHARAT HARIBA NANAWARE,Peoples Party of India (Democratic),1442,7,1449,0.12,S1341
13,SHRIKANT BABURAO HOVAL,Bahujan Mukti Party,1380,2,1382,0.11,S1341
14,PRAVIN MADHAV JOHARE,Swarajya Sena (Maharashtra),1268,5,1273,0.1,S1341
15,PANCHSHIL VIKRAM KAMBLE,Independent,1232,9,1241,0.1,S1341
16,SHANKAR HARI TADAKHE,Baliraja Party,1126,2,1128,0.09,S1341
17,AMOL MALU HANMANTE,Independent,1094,5,1099,0.09,S1341
18,ADV. KASBEKAR SHRIDHAR LIMBAJI,Rashtriya Sant Sandesh Party,987,7,994,0.08,S1341
19,BALAJI SHESHRAO BANSODE,Independent,953,1,954,0.08,S1341
20,BHIKAJI GANGARAM JADHAV,Kranti Kari Jai Hind Sena,863,3,866,0.07,S1341
21,VIKAS KONDIBA SHINDE,Maharashtra Vikas Aghadi,793,8,801,0.06,S1341
22,LAKHAN RAJARAM KAMBLE,Rashtriy Bahujan Party,790,5,795,0.06,S1341
23,BALAJI TUKARAM GAIKWAD,Bharat Peoples Sena,679,4,683,0.06,S1341
24,SUDHAKAR TUKARAM SURYAWANSHI,Independent,617,3,620,0.05,S1341
25,PAPITA RAOSAHEB RANDIVE,Independent,576,5,581,0.05,S1341
26,ADV. PRADIP S. CHINCHOLIKAR,Independent,528,5,533,0.04,S1341
27,MUKESH GOVINDRAO GHODAKE,Independent,524,1,525,0.04,S1341
28,PANKAJ GOPALRAO WAKHARADAKAR,Independent,512,1,513,0.04,S1341
29,NOTA,None of the Above,3542,25,3567,0.29,S1341
1,JYOTIRADITYA M. SCINDIA,Bharatiya Janata Party,919744,3558,923302,67.21,S124
2,YADVENDRA RAO DESHRAJ SINGH,Indian National Congress,380909,1464,382373,27.83,S124
3,DHANIRAM CHAUDHARY,Bahujan Samaj Party,30105,130,30235,2.2,S124
4,KANCHHEDI LAL KUSHWAHA,Mahanwadi Party,5850,6,5856,0.43,S124
5,ADVOCATE KARANSINGH JATAV,Aazad Samaj Party (Kanshi Ram),5474,11,5485,0.4,S124
6,HEMANT SINGH KUSHWAHA,Independent,3450,3,3453,0.25,S124
7,RAKESH,Independent,3051,1,3052,0.22,S124
8,MAHENDRA JAIN BHAIYAN,Independent,1990,9,1999,0.15,S124
9,MOHAN,Independent,1883,3,1886,0.14,S124
10,GAJANAND KUSHWAH,Independent,1595,2,1597,0.12,S124
11,MANISH SHRIVASTAVA,Socialist Unity Centre Of India (COMMUNIST),1342,6,1348,0.1,S124
12,MANMOHAN,Independent,1143,6,1149,0.08,S124
13,KISAN LAL AHIRWAR,Independent,1033,11,1044,0.08,S124
14,MOHAMMAD JAVED ANSARI,Rashtriya Jansena Party,983,0,983,0.07,S124
15,D.S. CHAUHAN (ADVOCATE),Rashtriya Samaj Paksha,913,2,915,0.07,S124
16,NOTA,None of the Above,9055,34,9089,0.66,S124
1,KARTICK CHANDRA PAUL,Bharatiya Janata Party,558644,2253,560897,40.99,S255
2,KALYANI KRISHNA,All India Trinamool Congress,491150,1550,492700,36,S255
3,ALI IMRAN RAMZ,Indian National Congress,262694,579,263273,19.24,S255
4,DWARIK NATH BARMAN,Independent,8258,6,8264,0.6,S255
5,MD NAZIR AKHTAR,Independent,6004,1,6005,0.44,S255
6,KALIDASH MURMU,Independent,5865,3,5868,0.43,S255
7,SWAPAN KUMAR DAS,Bahujan Samaj Party,4106,11,4117,0.3,S255
8,RUPAK ROY,Independent,3355,3,3358,0.25,S255
9,FAKIRA MD,Independent,3353,2,3355,0.25,S255
10,DURGA MURMU,Ambedkarite Party of India,3330,4,3334,0.24,S255
11,PALASH CHANDRA MAHATO,Independent,3112,2,3114,0.23,S255
12,ALI IMRAN,Independent,1939,7,1946,0.14,S255
13,MD ABRAHIM HOQUE,Independent,1761,2,1763,0.13,S255
14,SHAHIDUR RAHMAN,North Bengal People’s Party,1458,4,1462,0.11,S255
15,SHARANYA DUTTA,Independent,1328,2,1330,0.1,S255
16,SANATAN DUTTA,Socialist Unity Centre Of India (COMMUNIST),1256,15,1271,0.09,S255
17,TAPAN BARMAN,Jai Prakash Janata Dal,1249,2,1251,0.09,S255
18,ANWARUL HOQUE,Independent,1187,3,1190,0.09,S255
19,RAMESH CHANDRA SINHA,Bhumiputra United Party,1046,5,1051,0.08,S255
20,AL MONOWARA BEGAM,India Manus Party,977,5,982,0.07,S255
21,NOTA,None of the Above,1924,16,1940,0.14,S255
1,KINJARAPU RAMMOHAN NAIDU,Telugu Desam,734501,19827,754328,61.05,S012
2,TILAK PERADA,Yuvajana Sramika Rythu Congress Party,420394,6033,426427,34.51,S012
3,PEDADA PARAMESWARA RAO,Indian National Congress,6724,448,7172,0.58,S012
4,SANAPALA SRAVAN KUMAR,Independent,5950,8,5958,0.48,S012
5,NAIDUGARI RAJASEKHAR,Bahujan Samaj Party,4661,81,4742,0.38,S012
6,VABA YOGESWARA RAO,Independent,3472,126,3598,0.29,S012
7,BETHA VIVEKANANDA MAHARAJ,Independent,2523,13,2536,0.21,S012
8,YEDDU LAKSHMINARAYANA,Independent,1598,7,1605,0.13,S012
9,BORUBADRA CHANDRAKALA,Bharatha Chaitanya Yuvajana Party,1315,42,1357,0.11,S012
10,IPPILI SEETHARAJU,Jai Bharat National Party,1080,50,1130,0.09,S012
11,KAYA DURGARAO,Navarang Congress Party,811,7,818,0.07,S012
12,CHELLURI DANIYAL,Independent,796,20,816,0.07,S012
13,BOMMALI TIRUPATI RAO,Pyramid Party of India,589,5,594,0.05,S012
14,NOTA,None of the Above,24498,107,24605,1.99,S012
1,MALA ROY,All India Trinamool Congress,612725,2549,615274,49.48,S2523
2,DEBASREE CHAUDHURI,Bharatiya Janata Party,426459,1584,428043,34.42,S2523
3,SAIRA SHAH HALIM,Communist Party of India  (Marxist),167771,760,168531,13.55,S2523
4,NIRAJ AGARWAL,Independent,4028,4,4032,0.32,S2523
5,FIROZA KHATUN,Bahujan Samaj Party,3958,17,3975,0.32,S2523
6,SANTANU ROY,Independent,2918,2,2920,0.23,S2523
7,ZUBAIR RABBANI,Socialist Unity Centre Of India (COMMUNIST),2290,10,2300,0.18,S2523
8,SUSANTA MONDAL,Independent,2090,1,2091,0.17,S2523
9,MUMTAZ ALI,Independent,1960,9,1969,0.16,S2523
10,MUKTI,Right to Recall Party,1537,7,1544,0.12,S2523
11,SANJOY (RANA) CHANDA,Kisan Mazdoor Sangharsh Party,1186,7,1193,0.1,S2523
12,SANJANA RAM,Independent,1052,4,1056,0.08,S2523
13,YASMIN ISLAM,Social Democratic Party Of India,981,4,985,0.08,S2523
14,ATANU DAS,Independent,969,2,971,0.08,S2523
15,MRIDUL OJHA,Independent,856,6,862,0.07,S2523
16,DIPENDU HAZRA,Independent,794,10,804,0.06,S2523
17,MD. SHAKIL WARSI,Independent,503,1,504,0.04,S2523
18,NOTA,None of the Above,6348,75,6423,0.52,S2523
1,ANGOMCHA BIMOL AKOIJAM,Indian National Congress,370678,3339,374017,46.93,S141
2,THOUNAOJAM BASANTA KUMAR SINGH,Bharatiya Janata Party,262217,1999,264216,33.16,S141
3,MAHESHWAR THOUNAOJAM,Republican Party of India (Athawale),134308,1332,135640,17.02,S141
4,RAJKUMAR SOMENDRO SINGH,Independent,12892,158,13050,1.64,S141
5,MOIRANGTHEM TOTOMSHANA NONGSHABA,Independent,4831,50,4881,0.61,S141
6,HAORUNGBAM SARAT SINGH,Independent,1279,17,1296,0.16,S141
7,NOTA,None of the Above,3707,90,3797,0.48,S141
1,SUKANTA KUMAR PANIGRAHI,Bharatiya Janata Party,413320,3095,416415,41.8,S1813
2,ACHYUTANANDA SAMANTA,Biju Janata Dal,393644,1400,395044,39.66,S1813
3,AMIR CHAND NAYAK,Indian National Congress,143311,1011,144322,14.49,S1813
4,BHAGIRATHI BALIARSINGH,Manas Lokshakti Dal,7329,1,7330,0.74,S1813
5,KANAK MANJARI RATH,Independent,5201,4,5205,0.52,S1813
6,HARIBANDHU BEHERA,Bahujan Samaj Party,5121,16,5137,0.52,S1813
7,SUBASH MOHAPATRA,National Jan Dal,4133,4,4137,0.42,S1813
8,PARSURAM PRADHAN,Kalinga Sena,2770,11,2781,0.28,S1813
9,NOTA,None of the Above,15691,29,15720,1.58,S1813
1,MALA RAJYA LAKSHMI SHAH,Bharatiya Janata Party,455949,6654,462603,53.66,S281
2,JOT SINGH GUNSOLA,Indian National Congress,187602,2508,190110,22.05,S281
3,BOBY PANWAR,Independent,162469,5612,168081,19.5,S281
4,NAVNEET SINGH GOSAIN,Rashtriya Uttarakhand Party,9969,57,10026,1.16,S281
5,NEMCHAND,Bahujan Samaj Party,6786,122,6908,0.8,S281
6,BRIJ BHUSHAN KARANWAL,Bhartiya Rashtriya Ekta Dal,3545,25,3570,0.41,S281
7,SARDAR KHAN PAPPU,Independent,3268,7,3275,0.38,S281
8,VEPIN KUMAR AGGARWAL,Independent,3173,43,3216,0.37,S281
9,RAMPAL SINGH,Peoples Party of India (Democratic),2343,19,2362,0.27,S281
10,SUDESH TOMAR,Independent,2261,7,2268,0.26,S281
11,PREM DUTT SEMWAL,Independent,2134,30,2164,0.25,S281
12,NOTA,None of the Above,7304,154,7458,0.87,S281
1,DAGGUMALLA PRASADA RAO,Telugu Desam,765536,12535,778071,54.84,S0125
2,REDDEPPA.N .,Yuvajana Sramika Rythu Congress Party,552469,5123,557592,39.3,S0125
3,MOTUKUR JAGAPATHI,Indian National Congress,29431,719,30150,2.12,S0125
4,THOGURU VIJAYA KUMAR,Bahujan Samaj Party,13389,122,13511,0.95,S0125
5,YUGANDAR . KONDA,Independent,6889,84,6973,0.49,S0125
6,K.MUNI KRISHNA,Independent,3954,2,3956,0.28,S0125
7,P.JANAKI RAMA RAO ( BABU),National Maha Sabha Party,2822,11,2833,0.2,S0125
8,PETA.MOHAN .,Independent,2365,1,2366,0.17,S0125
9,C.SUDHAKAR,Independent,1934,1,1935,0.14,S0125
10,N.CHANDRABABU,Independent,1878,7,1885,0.13,S0125
11,MADASI SUDHARSHAN,Independent,1575,3,1578,0.11,S0125
12,D.MAHESH,Independent,1109,10,1119,0.08,S0125
13,P.MADHU,Independent,902,4,906,0.06,S0125
14,N.BHUPATHI,Independent,862,32,894,0.06,S0125
15,A. PURNA CHANDRA,Independent,856,1,857,0.06,S0125
16,PALLIPATTU.ABHINAV VISHNU,Samajwadi Party,670,6,676,0.05,S0125
17,N.GANGAIAH .,Independent,547,5,552,0.04,S0125
18,T NARESH,Independent,532,2,534,0.04,S0125
19,BANDAPALLI RAMESH,Independent,490,3,493,0.03,S0125
20,NOTA,None of the Above,11812,164,11976,0.84,S0125
1,RAVIKUMAR. D,Viduthalai Chiruthaigal Katchi,474230,2803,477033,41.39,S2213
2,BHAGYARAJ. J,All India Anna Dravida Munnetra Kazhagam,404503,1827,406330,35.25,S2213
3,MURALI SANKAR. S,Pattali Makkal Katchi,180020,1862,181882,15.78,S2213
4,KALANCHIYAM. M,Naam Tamilar Katchi,56766,476,57242,4.97,S2213
5,KARUNCHIRUTHAI KALIYAMURTHY. K,Bahujan Samaj Party,3883,37,3920,0.34,S2213
6,ARUMUGAM. M,United Republican Party of India,3487,17,3504,0.3,S2213
7,DHARMA. K,Independent,2375,7,2382,0.21,S2213
8,VIVEKANANDHAN. E,Independent,1945,8,1953,0.17,S2213
9,ARASAN. K,Independent,1835,7,1842,0.16,S2213
10,VIGNESVARAN. R,Independent,1643,13,1656,0.14,S2213
11,SURESH. S,Independent,1374,23,1397,0.12,S2213
12,PERIYAN. A,Independent,1041,8,1049,0.09,S2213
13,GUNASEKARAN. K,Independent,960,3,963,0.08,S2213
14,VIJAYAN. A,Independent,859,2,861,0.07,S2213
15,NAGARAJ. A,Independent,669,5,674,0.06,S2213
16,SURESH. K,Independent,592,6,598,0.05,S2213
17,SATHIYARAJ. N,Independent,412,3,415,0.04,S2213
18,NOTA,None of the Above,8874,92,8966,0.78,S2213
1,GOPAL JEE THAKUR,Bharatiya Janata Party,565706,924,566630,55.33,S0414
2,LALIT KUMAR YADAV,Rashtriya Janata Dal,387408,1066,388474,37.93,S0414
3,SAROJ CHAUDHARY,Mithilanchal Mukti Morcha,18018,7,18025,1.76,S0414
4,DURGANANDA MAHAVIR NAYAK,Bahujan Samaj Party,8259,9,8268,0.81,S0414
5,MITHILESH MAHTO,Independent,6983,9,6992,0.68,S0414
6,KISHOR KUMAR DAS,Akhil Bhartiya Parivar Party,5716,5,5721,0.56,S0414
7,RAJNISH KUMAR,Jantantra Awaj Party,3634,4,3638,0.36,S0414
8,RANJEET KUMAR RAM,Wazib Adhikar Party,2529,3,2532,0.25,S0414
9,NOTA,None of the Above,23881,23,23904,2.33,S0414
1,MURARI LAL MEENA,Indian National Congress,636868,9398,646266,60.24,S2011
2,KANHAIYA LAL MEENA,Bharatiya Janata Party,404309,4617,408926,38.12,S2011
3,SONU DHANKA,Bahujan Samaj Party,6752,45,6797,0.63,S2011
4,"DR. RAM ROOP MEENA, ADVOCATE",Independent,2701,20,2721,0.25,S2011
5,MOHAN LAL MEENA,Independent,2164,14,2178,0.2,S2011
6,NOTA,None of the Above,5789,57,5846,0.54,S2011
1,MAHENDRA SINGH SOLANKY,Bharatiya Janata Party,925917,3024,928941,63.23,S1221
2,RAJENDRA RADHAKISHAN MALVIYA,Indian National Congress,502548,1168,503716,34.29,S1221
3,RAJENDRASINGH CHOKHUTIYA,Bahujan Samaj Party,11162,41,11203,0.76,S1221
4,RAMPRASAD,Aazad Samaj Party (Kanshi Ram),7201,19,7220,0.49,S1221
5,NITIN VERMA,Independent,2756,5,2761,0.19,S1221
6,ADVOCATE VIDAYARAJ MALAVIY,Social Democratic Party Of India,2026,5,2031,0.14,S1221
7,ENG. DEEPAK RAMESH CHANDRA VICHITRA,Independent,1585,10,1595,0.11,S1221
8,HEMRAJ POONAMCHANDRA BAMNIYA,Public Political Party,1236,12,1248,0.08,S1221
9,NOTA,None of the Above,10365,24,10389,0.71,S1221
1,RANJIT DUTTA,Bharatiya Janata Party,771018,4770,775788,60.21,S0311
2,PREMLAL GANJU,Indian National Congress,412553,1827,414380,32.16,S0311
3,RISHIRAJ KAUNDINYA,Aam Aadmi Party,32771,277,33048,2.56,S0311
4,RAJU DEURI,Bodoland Peoples Front,19775,117,19892,1.54,S0311
5,PRADIP BHANDARI,Independent,8136,69,8205,0.64,S0311
6,KAMESWAR SWARGIARY,Voters Party  International,7320,62,7382,0.57,S0311
7,RINKU ROY,Gana Suraksha Party,6780,43,6823,0.53,S0311
8,ALAM ALI,Bahujan Maha Party,4186,16,4202,0.33,S0311
9,NOTA,None of the Above,18535,213,18748,1.46,S0311
1,PRIYA SAROJ,Samajwadi Party,449561,1731,451292,42.57,S2474
2,BHOLANATH (B.P. SAROJ),Bharatiya Janata Party,414494,948,415442,39.19,S2474
3,KRIPA SHANKAR SAROJ,Bahujan Samaj Party,156930,361,157291,14.84,S2474
4,SHRAVAN KUMAR,Independent,5804,3,5807,0.55,S2474
5,URMILA,Samaj Parivartan Party,5296,7,5303,0.5,S2474
6,SUBAS,Independent,3691,2,3693,0.35,S2474
7,RANG BAHADUR,Independent,2715,3,2718,0.26,S2474
8,BRIJESH KUMAR SAROJ,Prabuddhwadi Bahujan Morcha,2365,0,2365,0.22,S2474
9,RAJENDRA PRASAD,Rashtra Uday Party,2066,1,2067,0.19,S2474
10,RAM MILAN,Sardar Patel Siddhant Party,1713,3,1716,0.16,S2474
11,KAMLESH,Azad Samaj Party,1698,4,1702,0.16,S2474
12,BRIJESH KUMAR,Prithviraj Janshakti Party,1362,2,1364,0.13,S2474
13,NOTA,None of the Above,9277,26,9303,0.88,S2474
1,DR RAJKUMAR SANGWAN,Rashtriya Lok Dal,485765,3202,488967,52.36,S2411
2,AMARPAL,Samajwadi Party,328487,1021,329508,35.29,S2411
3,PRAVEEN BANSAL,Bahujan Samaj Party,91740,526,92266,9.88,S2411
4,MUKESH KUMAR SHARMA,Azad Adhikar Sena,5441,82,5523,0.59,S2411
5,MAHENDER SINGH,Sarvjan Samta Party,4957,63,5020,0.54,S2411
6,SUKHVIR SINGH,Swatantra Jantaraj Party,4056,43,4099,0.44,S2411
7,RUBY KASHYAP,Sarvjan Lok Shakti Party,3202,78,3280,0.35,S2411
8,NOTA,None of the Above,4980,130,5110,0.55,S2411
1,AFZAL ANSARI,Samajwadi Party,537784,2128,539912,46.82,S2475
2,PARS NATH RAI,Bharatiya Janata Party,413518,1533,415051,35.99,S2475
3,UMESH KUMAR SINGH,Bahujan Samaj Party,164601,363,164964,14.31,S2475
4,AJAY,Vishwa Kalyan Rashtriya Manav Samaj Party,5068,6,5074,0.44,S2475
5,NUSRAT ANSARI,Independent,4567,49,4616,0.4,S2475
6,ADITYA SHRIVASTAV,Yuga Thulasi Party,3312,4,3316,0.29,S2475
7,SATYDEV YADAV,Independent,3163,9,3172,0.28,S2475
8,GYANCHANDRA BIND,Independent,3127,8,3135,0.27,S2475
9,RAMPRAVESH,Moulik Adhikar Party,2830,3,2833,0.25,S2475
10,DHANANJAY KUMAR TIWARI,Bhartiya Lokvani Party,1949,7,1956,0.17,S2475
11,NOTA,None of the Above,9033,32,9065,0.79,S2475
1,BAPI HALDAR,All India Trinamool Congress,752486,3245,755731,50.52,S2520
2,ASHOK PURKAIT,Bharatiya Janata Party,552798,1876,554674,37.08,S2520
3,AJAY KUMAR DAS,All India Secular Front,87530,76,87606,5.86,S2520
4,DR SARAT CHANDRA HALDER,Communist Party of India  (Marxist),60778,322,61100,4.08,S2520
5,BAPI HALDER,Independent,8922,12,8934,0.6,S2520
6,BAPI HALDAR,Independent,5607,19,5626,0.38,S2520
7,BISWANATH SARDAR,Socialist Unity Centre Of India (COMMUNIST),4505,29,4534,0.3,S2520
8,PANKAJ KUMAR HALDER,Bahujan Samaj Party,4238,19,4257,0.28,S2520
9,ASHOKE PUROKAIT,Independent,1489,12,1501,0.1,S2520
10,ASHOKE SARDAR,Independent,1474,27,1501,0.1,S2520
11,BAPPA DAS,Party for Democratic Socialism,1203,6,1209,0.08,S2520
12,RUDRA PRASAD MANDAL,Mulnibasi Party of India,707,13,720,0.05,S2520
13,NOTA,None of the Above,8593,38,8631,0.58,S2520
1,JITAN RAM MANJHI,Hindustani Awam Morcha (Secular),492732,2228,494960,51.36,S0438
2,KUMAR SARVJEET,Rashtriya Janata Dal,390469,2679,393148,40.8,S0438
3,SUSHMA KUMARI,Bahujan Samaj Party,12234,142,12376,1.28,S0438
4,DEVENDRA PRATAP,Independent,9209,2,9211,0.96,S0438
5,DHEERENDRA PRASAD,Loktantrik Samajwadi Party,5616,13,5629,0.58,S0438
6,GIRIDHAR SAPERA,The National Road Map Party of India,4708,19,4727,0.49,S0438
7,RANU KUMAR CHAUDHARY,Independent,4495,10,4505,0.47,S0438
8,RANJAN KUMAR,Independent,4233,1,4234,0.44,S0438
9,AYUSH KUMAR,Independent,4098,5,4103,0.43,S0438
10,SURENDRA MANJHI,Rashtriya Jansambhavna Party,3023,12,3035,0.31,S0438
11,AMRESH KUMAR,Independent,2800,21,2821,0.29,S0438
12,ASHOK KUMAR PASWAN,Independent,2692,9,2701,0.28,S0438
13,ARUN KUMAR,Independent,2531,23,2554,0.27,S0438
14,SHEO SHANKAR,Bhartiya Lok Chetna Party,2370,14,2384,0.25,S0438
15,NOTA,None of the Above,17177,111,17288,1.79,S0438
1,ARUNA. D. K,Bharatiya Janata Party,506747,4000,510747,41.66,S2911
2,CHALLA VAMSHI CHAND REDDY,Indian National Congress,503111,3136,506247,41.29,S2911
3,MANNE SRINIVAS REDDY,Bharat Rashtra Samithi,154296,496,154792,12.62,S2911
4,VENKATESWARLU TALLADA,Alliance of Democratic Reforms Party,6375,4,6379,0.52,S2911
5,KINNERA YADAGIRI,Independent,4470,0,4470,0.36,S2911
6,KURA VENKATAIAH,Independent,4248,1,4249,0.35,S2911
7,HARINDER REDDY MALLELA,Independent,3814,1,3815,0.31,S2911
8,KARUKONDA SRINIVAS YADAV,Independent,3450,1,3451,0.28,S2911
9,HANUMESH,Independent,3225,0,3225,0.26,S2911
10,MOHD ALAUDDIN,Bahujan Samaj Party,3056,21,3077,0.25,S2911
11,GOVINDAMMA,Independent,2748,0,2748,0.22,S2911
12,GANTLAVELLI RAKESH,Dharma Samaj Party,2600,18,2618,0.21,S2911
13,UMASHANKAR NEMMIKANTI,Independent,2214,0,2214,0.18,S2911
14,DINESH,Independent,1726,1,1727,0.14,S2911
15,ANDHARI ANJAIAH,Independent,1669,6,1675,0.14,S2911
16,SANGEPAGA SAROJANAMMA,Independent,1563,2,1565,0.13,S2911
17,B. RAVINDER,Social Justice Party of India,1082,3,1085,0.09,S2911
18,K. UDAY TEJ NAIK,Independent,1027,0,1027,0.08,S2911
19,MARLA ANJANEYULU,Jai Swaraj Party,1019,1,1020,0.08,S2911
20,NADIMINTI SRINIVASULU,Independent,983,2,985,0.08,S2911
21,M. NAVEEN REDDY,Independent,951,1,952,0.08,S2911
22,VIJAYA,Independent,592,4,596,0.05,S2911
23,ANEESUR RAHMAN,Bahujan Mukti Party,503,0,503,0.04,S2911
24,A. SRINIVASULU,Independent,437,1,438,0.04,S2911
25,KADINTI SHANKAR REDDY,Viduthalai Chiruthaigal Katchi,427,5,432,0.04,S2911
26,NARESH REDDY,Telangana Jaghir Party,420,0,420,0.03,S2911
27,VENKATA RAMANA,Independent,352,1,353,0.03,S2911
28,BANDA SATYANARAYANA,Independent,263,1,264,0.02,S2911
29,PULLANGARI SANDEEP KUMAR REDDY,Independent,261,1,262,0.02,S2911
30,VISHNU VARDHAN REDDY THAPALAKINDHI,Independent,227,2,229,0.02,S2911
31,MUDAVATH BALARAJU NAIK,Independent,181,2,183,0.01,S2911
32,NOTA,None of the Above,4286,44,4330,0.35,S2911
1,BHUMARE SANDIPANRAO ASARAM,Shiv Sena,474434,1696,476130,36.56,S1319
2,IMTIAZ JALEEL SYED,All India Majlis-E-Ittehadul Muslimeen,340877,603,341480,26.22,S1319
3,CHANDRAKANT KHAIRE,Shiv Sena (Uddhav Balasaheb Thackrey),291870,1580,293450,22.53,S1319
4,AFSAR KHAN YASEEN KHA,Vanchit Bahujan  Aaghadi,69087,179,69266,5.32,S1319
5,HARSHWARDHAN DADA RAIBHANJI JADHAV,Independent,39654,174,39828,3.06,S1319
6,SURENDRA DIGAMBAR GAJBHARE,Independent,10719,6,10725,0.82,S1319
7,SANJAY UTTAMRAO JAGTAP,Bahujan Samaj Party,8188,64,8252,0.63,S1319
8,RAVINDRA BHASKARRAO BODKHE,Bharatiya Yuva Jan Ekta Party,6250,4,6254,0.48,S1319
9,ABDUL AZIM ABDUL AZIZ SHAIKH,Independent,4693,0,4693,0.36,S1319
10,SANJAY BHASKAR SHIRSAT,Independent,3809,3,3812,0.29,S1319
11,DR JIVAN BHAWLAL RAJPUT,Independent,3788,19,3807,0.29,S1319
12,MANISHA KHARAT,Bahujan Maha Party,3097,8,3105,0.24,S1319
13,JAGANNATH KHANDERAO JADHAV J K JADHAV,Independent,2916,16,2932,0.23,S1319
14,MAANOJ VINAYAKRAO GHODKAY,Independent,2582,5,2587,0.2,S1319
15,SANGITA GANESH JADHAV,Independent,2206,6,2212,0.17,S1319
16,GALPHADE ARJUN BHAGWANRAO,Rashtriya Kisan Bahujan Party,2185,7,2192,0.17,S1319
17,VISHAL UDDHAV NANDARKAR,Independent,2132,7,2139,0.16,S1319
18,ARVIND KISANRAO KAMBLE,Bahujan Republican  Socialist Party,1975,4,1979,0.15,S1319
19,PRASHANT PUNDALIKRAO AVHALE,Independent,1945,3,1948,0.15,S1319
20,GHUGE NITIN PUNDLIK,Independent,1870,2,1872,0.14,S1319
21,BHALERAO VASANT SAMBHAJI,Prabuddha Republican Party,1546,1,1547,0.12,S1319
22,BHARAT PURUSHOTTAM KADAM,Rashtriya Maratha Party,1489,6,1495,0.11,S1319
23,ABDUL SAMAD BAGWAN,All India Majlis-E-Inquilab-E-Millat,1478,4,1482,0.11,S1319
24,SANDIP DADARAO MANKAR,Independent,1373,2,1375,0.11,S1319
25,ADV B U GOSAWI,Hindustan Janta Party,1271,4,1275,0.1,S1319
26,PANCHASHILA BABULAL JADHAV,Republican Bahujan Sena,1267,7,1274,0.1,S1319
27,PRATIKSHA PRASHANT CHAVAN,Ambedkarist Republican Party,1187,7,1194,0.09,S1319
28,BHANUDAS SON OF RAMDAS SARODE PATIL,Independent,1107,3,1110,0.09,S1319
29,NARAYAN JADHAV,Peoples Party of India (Democratic),1100,3,1103,0.08,S1319
30,SURESH ASARAM FULARE,Independent,910,1,911,0.07,S1319
31,SHAIKH KHAJA KISMATWALA KASIM KISMATWALA,Independent,892,2,894,0.07,S1319
32,MEENASING AVDHESHSING SING,Independent,783,1,784,0.06,S1319
33,LATIF JABBAR KHAN,Independent,765,0,765,0.06,S1319
34,JAGANNATH KISAN UGALE,Independent,753,2,755,0.06,S1319
35,SANDIP DEVIDAS JADHAV,Independent,609,0,609,0.05,S1319
36,DEVIDAS RATAN KASBE,Independent,595,0,595,0.05,S1319
37,TRIBHUVAN MADHUKAR PADMAKAR,Independent,593,0,593,0.05,S1319
38,NOTA,None of the Above,5729,44,5773,0.44,S1319
1,HARSIMRAT KAUR BADAL,Shiromani Akali Dal,375019,1539,376558,32.71,S1911
2,GURMEET SINGH KHUDIAN,Aam Aadmi Party,325019,1883,326902,28.4,S1911
3,JEETMOHINDER SINGH SIDHU,Indian National Congress,200859,1152,202011,17.55,S1911
4,PARAMPAL KAUR SIDHU,Bharatiya Janata Party,110255,507,110762,9.62,S1911
5,LAKHVIR SINGH LAKHA SIDHANA,Shiromani Akali Dal (Amritsar)(Simranjit Singh Mann),84222,462,84684,7.36,S1911
6,NIKKA SINGH,Bahujan Samaj Party,12979,60,13039,1.13,S1911
7,JAGJIWAN BALLI,Independent,5480,4,5484,0.48,S1911
8,PARWINDER SINGH,Independent,4494,3,4497,0.39,S1911
9,PALA RAM,Independent,3428,7,3435,0.3,S1911
10,BHAGWANT SINGH SAMAON,Independent,3372,16,3388,0.29,S1911
11,GURMEET SINGH,Independent,3072,10,3082,0.27,S1911
12,JASVIR SINGH BATHINDA,Aazad Samaj Party (Kanshi Ram),3039,106,3145,0.27,S1911
13,GURPREET SINGH URF PREET GHAINT,Jan Sewa Driver Party,2619,9,2628,0.23,S1911
14,GURBARN SINGH,Independent,1618,9,1627,0.14,S1911
15,NAIB SINGH,Bharatheeya Jawan Kisan Party,1593,8,1601,0.14,S1911
16,KULWANT SINGH,Independent,1172,10,1182,0.1,S1911
17,AMANDEEP SINGH,Independent,1146,2,1148,0.1,S1911
18,POONAM RANI,Nationalist Justice Party,1060,4,1064,0.09,S1911
19,NOTA,None of the Above,4818,115,4933,0.43,S1911
1,DR CHANDRA SEKHAR PEMMASANI,Telugu Desam,851020,13928,864948,60.68,S0113
2,KILARI VENKATA ROSAIAH,Yuvajana Sramika Rythu Congress Party,513563,6690,520253,36.5,S0113
3,JANGALA AJAY KUMAR,Communist Party of India,8317,320,8637,0.61,S0113
4,SIVAREDDY. ENDREDDY,Navataram Party,5628,1,5629,0.39,S0113
5,TENALI PRAKASH,Bahujan Samaj Party,4172,100,4272,0.3,S0113
6,SIKHAKOLLI HEMA GOWRI SHANKAR,Jatiya Jana Sena Party,1959,5,1964,0.14,S0113
7,SAMUDRALA CHINNA KOTAIAH,Jaibhim Rao Bharat Party,1748,5,1753,0.12,S0113
8,UMAR BHASHA SHAIK,Jana Sahayaka Sakthi,1273,2,1275,0.09,S0113
9,SYED. SAIDA,Navarang Congress Party,1216,6,1222,0.09,S0113
10,AMBATI CHALAMAIAH,Pyramid Party of India,1029,2,1031,0.07,S0113
11,PILLI BABU RAO,Independent,688,4,692,0.05,S0113
12,HARI VENKATA SATISH  KURNALA,Jai Bharat National Party,540,2,542,0.04,S0113
13,VISHNU REDDY LANKIREDDY,Bengaluru Nava Nirmana Party,461,0,461,0.03,S0113
14,EMANI. CHANDRASEKHAR RAO,Navodayam Party,409,5,414,0.03,S0113
15,SHAIK. KHAJAVALI,Independent,387,4,391,0.03,S0113
16,CHALLAPALLI RATAN RAJU,Viduthalai Chiruthaigal Katchi,374,4,378,0.03,S0113
17,KANNEBOYINA VAMSI KRISHNA YADAV,Independent,368,7,375,0.03,S0113
18,MOHAMMAD KHAJA MOINUDDIN CHISTI PASHA,Andhra Pradesh Rashtra Samithi,353,5,358,0.03,S0113
19,GAYATRI AUDHIPUDI,Independent,350,7,357,0.03,S0113
20,ASHOK ANAND GALI,Independent,335,0,335,0.02,S0113
21,SHAIK ASLAM AKTHER,Independent,334,1,335,0.02,S0113
22,PATHAN KHAJA (BASHA),Telugu Rajadhikara Samiti Party,328,4,332,0.02,S0113
23,AMARTHALURI VENKATESWARA RAO.,Marxist Communist Party of India (United),308,4,312,0.02,S0113
24,DR. RAYAPUDI RAJESH VIJAY KUMAR,Indian Labour Party (Ambedkar Phule),306,4,310,0.02,S0113
25,BURAGA RATNAM,Loktantrik Janta Dal,304,12,316,0.02,S0113
26,VANKAYALAPATI VENKATA SIVA RAMANJANEYULU,Independent,268,0,268,0.02,S0113
27,SIVA PARVATHI,Independent,262,4,266,0.02,S0113
28,BOMMASANI MUTYALA RAO,All Peoples Party,200,7,207,0.01,S0113
29,SRIKRISHNA AKKISETTI,Independent,179,0,179,0.01,S0113
30,MADAVARAPU NAGA RAJU,Independent,172,0,172,0.01,S0113
31,NOTA,None of the Above,7210,177,7387,0.52,S0113
1,GOVIND MAKTHAPPA KARJOL,Bharatiya Janata Party,681217,3673,684890,50.11,S1018
2,B.N.CHANDRAPPA,Indian National Congress,634152,2617,636769,46.58,S1018
3,ASHOKA CHAKRAVARTHI,Bahujan Samaj Party,7679,26,7705,0.56,S1018
4,NARASIMHARAJU. C.N.,Karnataka Rashtra Samithi,4932,18,4950,0.36,S1018
5,SRINIVASAPURADA SRINIVASABABU PAVAGADA,Independent,4539,9,4548,0.33,S1018
6,"B. VENKATESHA, SHILPI",Independent,4196,5,4201,0.31,S1018
7,MANJUNATHA SWAMY T,Independent,2652,24,2676,0.2,S1018
8,BHUTHARAJA. V.S.,Independent,2386,11,2397,0.18,S1018
9,RAGHU KUMAR .S,Independent,2318,19,2337,0.17,S1018
10,RAMESH NAIK .T.,Uttama Prajaakeeya Party,2187,19,2206,0.16,S1018
11,NAGARAJAPPA,Independent,1674,5,1679,0.12,S1018
12,K  NARASHIMAMURTHY,Independent,1385,12,1397,0.1,S1018
13,SUDHAKARA .R,Independent,1201,10,1211,0.09,S1018
14,TULASI.H,Independent,1065,17,1082,0.08,S1018
15,GANESH.,Independent,1048,45,1093,0.08,S1018
16,SHABAREESH.,Karunada Sevakara Party,1014,4,1018,0.07,S1018
17,SUJATHA .D.,Socialist Unity Centre Of India (COMMUNIST),996,18,1014,0.07,S1018
18,DR M.P. DARAKESWARAIAH,Independent,982,10,992,0.07,S1018
19,AMRUTH RAJA.,Independent,804,30,834,0.06,S1018
20,B.T. RAMASUBBAIAH,Indian Movement Party,718,2,720,0.05,S1018
21,NOTA,None of the Above,3156,34,3190,0.23,S1018
1,PRADYUT BORDOLOI,Indian National Congress,786620,2230,788850,50.89,S039
2,SURESH BORAH,Bharatiya Janata Party,573579,3040,576619,37.2,S039
3,AMINUL ISLAM,All India United Democratic Front,137033,307,137340,8.86,S039
4,SIKHA SARMA,Independent,6569,51,6620,0.43,S039
5,SAMSUL ALAM,Independent,5048,21,5069,0.33,S039
6,BIPAD BHANJAN SARKAR,Independent,4878,7,4885,0.32,S039
7,ANUPAM BARUAH,Jai Prakash Janata Dal,4290,29,4319,0.28,S039
8,NIKHIL DEKARAJA,Independent,3601,26,3627,0.23,S039
9,RABBUL HAQUE,Rashtriya Ulama Council,2547,12,2559,0.17,S039
10,ABU SHAMA,Independent,2216,22,2238,0.14,S039
11,ABU EUSUF MD RAIHAN UDDIN,Independent,2019,11,2030,0.13,S039
12,SANTANU MUKHERJEE,Bharatiya Gana Parishad,1993,17,2010,0.13,S039
13,SAIFUL ISLAM CHOUDHURY,Asom Jana Morcha,1823,14,1837,0.12,S039
14,NOTA,None of the Above,11910,85,11995,0.77,S039
1,SELJA,Indian National Congress,732298,1525,733823,54.17,S073
2,ASHOK TANWAR,Bharatiya Janata Party,464472,854,465326,34.35,S073
3,SANDEEP LOT VALMIKI,Indian National Lok Dal,92279,174,92453,6.82,S073
4,RAMESH KHATAK,Jannayak Janta Party,20049,31,20080,1.48,S073
5,LILU RAM ASAKHERA,Bahujan Samaj Party,10120,31,10151,0.75,S073
6,RAHUL CHOUHAN,Independent,6159,1,6160,0.45,S073
7,KARNAIL SINGH ODHAN,Independent,4152,14,4166,0.31,S073
8,SATPAL LADWAL,Independent,3413,0,3413,0.25,S073
9,MISTRI DAULAT RAM ROLAN,Peoples Party of India (Democratic),3058,3,3061,0.23,S073
10,JOGINDER RAM,Independent,2140,2,2142,0.16,S073
11,RAN SINGH PANWAR,Independent,1548,2,1550,0.11,S073
12,RAJINDER KUMAR,Bharatiya Asha Party,1239,3,1242,0.09,S073
13,BAGDAWAT RAM,Independent,1221,3,1224,0.09,S073
14,JASVIR SINGH,Independent,1128,8,1136,0.08,S073
15,NAVEEN KUMAR COMMANDO,Independent,1113,3,1116,0.08,S073
16,SUKHDEV SINGH SANDHU,Independent,993,6,999,0.07,S073
17,DR. RAJESH MEHANDIA,Bahujan Republican  Socialist Party,931,0,931,0.07,S073
18,DHARAMPAL VARTIA,Loktantrik Lok Rajyam Party,916,3,919,0.07,S073
19,SURENDER KUMAR PHULAN,Independent,614,3,617,0.05,S073
20,NOTA,None of the Above,4106,17,4123,0.3,S073
1,DR. RAJESH MISHRA,Bharatiya Janata Party,582664,895,583559,50.87,S1211
2,KAMLESHWAR INDRAJIT KUMAR,Indian National Congress,376336,807,377143,32.87,S1211
3,AJAY PRATAP SINGH,Gondvana Gantantra Party,50897,65,50962,4.44,S1211
4,PUJAN RAM SAKET (BABBU),Bahujan Samaj Party,33617,39,33656,2.93,S1211
5,LAXMAN SINGH BAIS,Independent,30634,28,30662,2.67,S1211
6,SANJAY NAMDEO,Communist Party of India,20284,6,20290,1.77,S1211
7,BHAGWAN PRASAD TIWARI,Independent,7330,1,7331,0.64,S1211
8,SUNIL TIWARI,Independent,5694,5,5699,0.5,S1211
9,SHYAMLAL VAISH,Bhartiya Shakti Chetna Party,5340,3,5343,0.47,S1211
10,KAILASH PRASAD VERMA,Independent,5289,2,5291,0.46,S1211
11,MAHENDRA BHAIYA,Independent,4658,0,4658,0.41,S1211
12,DASHRATH PRASAD BAIS,Independent,4131,0,4131,0.36,S1211
13,"NARAYAN DAS SHAH ""MULNIWASI""",Peoples Party of India (Democratic),3791,1,3792,0.33,S1211
14,DADDI YADAV,Independent,3301,4,3305,0.29,S1211
15,SMT. TARA DEVI SINGH,Rashtriya Jansanchar Dal,2701,6,2707,0.24,S1211
16,RAMSAHAY SAHU,Aapka Gantantra Party,2430,2,2432,0.21,S1211
17,RAMVISHAL KOL,Rashtriya Samaj Paksha,2079,8,2087,0.18,S1211
18,NOTA,None of the Above,4212,4,4216,0.37,S1211
1,DILIP SAIKIA,Bharatiya Janata Party,864583,3804,868387,47.95,S034
2,MADHAB RAJBANGSHI,Indian National Congress,538032,1343,539375,29.78,S034
3,DURGADAS BORO,Bodoland Peoples Front,309040,1534,310574,17.15,S034
4,DANIEL MARDI,Independent,14277,14,14291,0.79,S034
5,AROON BAROOA,Bharatheeya Jawan Kisan Party,12519,44,12563,0.69,S034
6,SWARNA DEVI,Gana Suraksha Party,11067,45,11112,0.61,S034
7,LALIT PEGU,Voters Party  International,10887,28,10915,0.6,S034
8,JITENDRA CHALIHA,Socialist Unity Centre Of India (COMMUNIST),7421,31,7452,0.41,S034
9,ABUL KASEM,Republican Party of India (Athawale),4956,17,4973,0.27,S034
10,BIREN BASAK,Bharatiya Gana Parishad,4605,18,4623,0.26,S034
11,ABDUL HAMED,Rashtriya Ulama Council,3721,10,3731,0.21,S034
12,NOTA,None of the Above,23086,118,23204,1.28,S034
1,DAYANIDHI MARAN,Dravida Munnetra Kazhagam,412286,1562,413848,56.65,S224
2,VINOJ,Bharatiya Janata Party,168059,1100,169159,23.16,S224
3,B. PARTHASARATHY,Desiya Murpokku Dravida Kazhagam,71772,244,72016,9.86,S224
4,DR.R.KARTHIKEYAN,Naam Tamilar Katchi,45865,166,46031,6.3,S224
5,ANBAZHAGAN.G,Independent,3175,11,3186,0.44,S224
6,DILAVAR ALI,Tipu Sultan Party,2536,10,2546,0.35,S224
7,SAMARAN,Bahujan Samaj Party,2132,15,2147,0.29,S224
8,L.KASINATHAN,Independent,1059,1,1060,0.15,S224
9,AGNI AALVAR,Independent,783,4,787,0.11,S224
10,C.S.KARNAN,Anti Corruption Dynamic Party,750,11,761,0.1,S224
11,M.L.RAVI,Desiya Makkal Sakthi Katchi,690,6,696,0.1,S224
12,S.KANDASAMY,Independent,595,1,596,0.08,S224
13,DHAYANIDHI SURESH,Independent,565,2,567,0.08,S224
14,S.SATHISH KUMAR,Independent,526,1,527,0.07,S224
15,P.ARJUNAN,Independent,502,7,509,0.07,S224
16,S.SATHISH KUMAR,Independent,500,1,501,0.07,S224
17,G.OMPRAKASH,Independent,486,2,488,0.07,S224
18,V.V.TAMILARASAN,Independent,386,3,389,0.05,S224
19,UDAYA KUMAR.V,Independent,382,0,382,0.05,S224
20,B.PARTHASARATHY,Independent,377,3,380,0.05,S224
21,K.CHANDRASEKAR,Naadaalum Makkal Katchi,373,0,373,0.05,S224
22,N.RAMAN,Tamilnadu Makkal Nalvazhvu Periyakkam,311,3,314,0.04,S224
23,R.MINNAL RAJ,Independent,310,0,310,0.04,S224
24,R.VIJAY,Independent,268,0,268,0.04,S224
25,A.SELVA KUMAR,Thakkam Katchi,265,5,270,0.04,S224
26,M.NAGARAJ,Independent,254,0,254,0.03,S224
27,J.NAGARAJ,Independent,238,3,241,0.03,S224
28,SENTHILKUMAR,Chennai Youth Party,222,1,223,0.03,S224
29,RANJITHKUMAR.S,Independent,215,0,215,0.03,S224
30,RAVI BALARAMAN,Independent,182,1,183,0.03,S224
31,MANJUNATHA.R,Independent,159,0,159,0.02,S224
32,NOTA,None of the Above,11082,81,11163,1.53,S224
1,CHANDRA PRAKASH JOSHI,Bharatiya Janata Party,882334,5868,888202,59.26,S2021
2,ANJANA UDAILAL,Indian National Congress,495177,3148,498325,33.25,S2021
3,BHIL ADIVASI MANGILAL NANAMA,Bharat Adivasi Party,42243,568,42811,2.86,S2021
4,RAMESHWAR LAL BAIRWA (INDORA),Independent,9536,3,9539,0.64,S2021
5,KUMAWAT RAMESH CHANDRA,Independent,8834,8,8842,0.59,S2021
6,MEGHWAL RADHESHYAM,Bahujan Samaj Party,8578,35,8613,0.57,S2021
7,SHYAM LAL MEGHWAL,Independent,7901,6,7907,0.53,S2021
8,BAPU LAL ANJANA,Independent,7837,9,7846,0.52,S2021
9,PRAKASH DHAKAR,Ekam Sanatan Bharat Dal,3915,10,3925,0.26,S2021
10,PRATAP SINGH,Independent,3342,5,3347,0.22,S2021
11,AZAD PRAKASH CHANDRA MEGHWAL,Akhil Bharatiya Congress Dal (Ambedkar),2764,13,2777,0.19,S2021
12,JOGENDRA SINGH HODA,Independent,2294,8,2302,0.15,S2021
13,GAJENDRA,Independent,1637,7,1644,0.11,S2021
14,KALYAN SINGH BHATI,Independent,1544,18,1562,0.1,S2021
15,MAHAVIR PRASAD KUMAWAT,Right to Recall Party,1539,10,1549,0.1,S2021
16,KAMAL,Independent,1490,8,1498,0.1,S2021
17,MOHAMMAD WAHID KHAN,Pehchan People’s Party,1216,12,1228,0.08,S2021
18,SITA RAM AHIR,Vishva Shakti Party,1203,23,1226,0.08,S2021
19,NOTA,None of the Above,5518,72,5590,0.37,S2021
1,BABU SINGH KUSHWAHA,Samajwadi Party,506076,3054,509130,46.21,S2473
2,KRIPASHANKAR SINGH,Bharatiya Janata Party,408512,1283,409795,37.19,S2473
3,SHYAM SINGH YADAV,Bahujan Samaj Party,156691,446,157137,14.26,S2473
4,SARFARAZ AHMAD,Independent,2750,0,2750,0.25,S2473
5,ASHOK SINGH,Samaj Vikas Kranti Party,2749,6,2755,0.25,S2473
6,JIYALAL PRAJAPATI,Bhagidari Party(P),2232,3,2235,0.2,S2473
7,SHRIPATI MAURYA,Independent,2091,3,2094,0.19,S2473
8,SHAH ALAM,Apna Dal (Kamerawadi),2003,0,2003,0.18,S2473
9,FULACHANDR,Moulik Adhikar Party,1632,1,1633,0.15,S2473
10,KRIPASHANKAR C PANDEY,Independent,1446,1,1447,0.13,S2473
11,GOVIND LAL,Independent,1387,2,1389,0.13,S2473
12,RAM PYARE,Socialist Unity Centre Of India (COMMUNIST),1160,1,1161,0.11,S2473
13,NISHA PATEL,Sardar Patel Siddhant Party,1125,3,1128,0.1,S2473
14,BHARAT RAM,Pachchasi Parivartan Samaj Party,802,0,802,0.07,S2473
15,NOTA,None of the Above,6301,28,6329,0.57,S2473
1,SURESH KUMAR SHETKAR,Indian National Congress,523919,4499,528418,42.73,S295
2,B. B. PATIL,Bharatiya Janata Party,476023,6207,482230,39,S295
3,ANILKUMAR GALI,Bharat Rashtra Samithi,171412,666,172078,13.92,S295
4,KOTHA BALIJA BASWARAJ,Telangana Praja Shakthi Party,8362,11,8373,0.68,S295
5,CHAVAGANI MANI,Alliance of Democratic Reforms Party,6295,14,6309,0.51,S295
6,YAKUB SHARIF MD,Independent,5484,5,5489,0.44,S295
7,MAHADHEV SWAMI MATAM,Independent,5408,4,5412,0.44,S295
8,B. MARUTHI RAO,Independent,4248,4,4252,0.34,S295
9,S. RAJU,Independent,3511,3,3514,0.28,S295
10,SATYANARAYANA GOUD KOVURI,Independent,2875,1,2876,0.23,S295
11,RAMESH. SAJJAPUR.,Independent,2477,2,2479,0.2,S295
12,KAMMARI ANANDEESHWAR,Independent,2381,3,2384,0.19,S295
13,JAIPAL NAYAK JADAVATH,Independent,2217,51,2268,0.18,S295
14,GURRAPU MACHANDER,All India Forward Bloc,1760,9,1769,0.14,S295
15,T.D.S. MANI,Dharma Samaj Party,1628,27,1655,0.13,S295
16,MOHD SADDAM,Independent,1567,1,1568,0.13,S295
17,MALEPU MOHAN REDDY,Pyramid Party of India,1095,7,1102,0.09,S295
18,ASHOK TALARI,Independent,831,6,837,0.07,S295
19,ROMALA BABU DURGAIAH,India Praja Bandhu Party,601,2,603,0.05,S295
20,NOTA,None of the Above,2933,44,2977,0.24,S295
1,NISHIKANT DUBEY,Bharatiya Janata Party,688879,4261,693140,49.57,S273
2,PRADEEP YADAV,Indian National Congress,586104,5223,591327,42.29,S273
3,UDAY SHANKAR KHAWARE,Independent,26831,6,26837,1.92,S273
4,ARUN MARIK,Independent,17436,1,17437,1.25,S273
5,NILESH KUMAR GUPTA,Independent,10485,3,10488,0.75,S273
6,AVISEK ANAND JHA,Independent,9601,35,9636,0.69,S273
7,BAJRANGI MAHTHA,Bahujan Samaj Party,8151,24,8175,0.58,S273
8,MUKESH KUMAR JHA,Independent,7366,0,7366,0.53,S273
9,KUMARI DILESHWARI,Ambedkarite Party of India,6578,3,6581,0.47,S273
10,RAMESHWAR MANDAL,Peoples Party of India (Democratic),3315,1,3316,0.24,S273
11,SURAJ KUMAR AMAN,Bhagidari Party(P),3070,3,3073,0.22,S273
12,ARUN KUMAR,Nyaydharmsabha,2891,2,2893,0.21,S273
13,DR. K. RANGAIAH,Independent,2205,5,2210,0.16,S273
14,BRAJKISHORE PANDIT,Akhil Bhartiya Manavadhikar Vichar Manch Party,2102,6,2108,0.15,S273
15,ANUP KUMAR,"Proutist Bloc, India",2003,4,2007,0.14,S273
16,KALIPADA MURMU,Socialist Unity Centre Of India (COMMUNIST),1935,6,1941,0.14,S273
17,KETAN KUMAR,Right to Recall Party,1896,2,1898,0.14,S273
18,TIPLAL SAH,Lokhit Adhikar Party,1765,5,1770,0.13,S273
19,GYANESHWAR JHA,Jagrook Janta Party,1637,3,1640,0.12,S273
20,NOTA,None of the Above,4309,52,4361,0.31,S273
1,ADHIKARI DEEPAK (DEV),All India Trinamool Congress,834558,3432,837990,52.36,S2532
2,DR. HIRANMOY CHATTOPADHYAYA,Bharatiya Janata Party,652098,3024,655122,40.93,S2532
3,TAPAN GANGULI,Communist Party of India,74399,509,74908,4.68,S2532
4,SOUMEN MADRAJI,Bahujan Samaj Party,7916,25,7941,0.5,S2532
5,GOPAL MONDAL,Independent,4238,6,4244,0.27,S2532
6,DINESH MAIKAP,Socialist Unity Centre Of India (COMMUNIST),4124,24,4148,0.26,S2532
7,SAHEB CHOWDHURY,Independent,3228,9,3237,0.2,S2532
8,NOTA,None of the Above,12889,77,12966,0.81,S2532
1,JYOTIRMAY SINGH MAHATO,Bharatiya Janata Party,576246,2243,578489,40.34,S2535
2,SHANTIRAM MAHATO,All India Trinamool Congress,559325,2085,561410,39.15,S2535
3,NEPAL CHANDRA MAHATO,Indian National Congress,128565,592,129157,9.01,S2535
4,AJIT PRASAD MAHATA,Independent,98381,277,98658,6.88,S2535
5,DHIRENDRANATH MAHATO,All India Forward Bloc,14498,74,14572,1.02,S2535
6,SONTOSH RAJOWARD,Bahujan Samaj Party,7739,21,7760,0.54,S2535
7,SUSMITA MAHATO,Socialist Unity Centre Of India (COMMUNIST),6078,31,6109,0.43,S2535
8,GORISH ROY,Independent,4800,9,4809,0.34,S2535
9,BHAGWAT DASS SHASTRI,Independent,4508,4,4512,0.31,S2535
10,ASIT BARAN MAHATO,Party for Democratic Socialism,3868,9,3877,0.27,S2535
11,PIJUSH KANTI RAJAK,Independent,3408,10,3418,0.24,S2535
12,AJIT MAHATO,Independent,3309,9,3318,0.23,S2535
13,NOTA,None of the Above,17871,58,17929,1.25,S2535
1,SUDAMA PRASAD,Communist Party of India  (Marxist-Leninist)  (Liberation),526564,2818,529382,48.28,S0432
2,R. K. SINGH,Bharatiya Janata Party,464736,4838,469574,42.82,S0432
3,VIRENDRA KUMAR SINGH,Independent,23630,5,23635,2.16,S0432
4,SHIV DAS SINGH,Independent,13373,6,13379,1.22,S0432
5,LAL BADSAH SINGH,Bahujan Samaj Party,10631,195,10826,0.99,S0432
6,KRISHNA PASWAN,Bhartiya Kranti Vir Party,8709,40,8749,0.8,S0432
7,RANDHIR LAL,Independent,5765,1,5766,0.53,S0432
8,NAVNIT KUMAR,Independent,4764,9,4773,0.44,S0432
9,RAM SARE SINGH,Peoples Party of India (Democratic),2531,10,2541,0.23,S0432
10,DHARMATMA SHARMA,Socialist Unity Centre Of India (COMMUNIST),2449,18,2467,0.22,S0432
11,RAMJEE SINGH,Voters Party  International,2435,5,2440,0.22,S0432
12,ASHOK TIWARY,Independent,2263,32,2295,0.21,S0432
13,MANMOHAN SINGH,Rashtrawadi Janlok Party (Satya),2055,42,2097,0.19,S0432
14,SUMITRA DEVI,Jagrook Janta Party,1640,34,1674,0.15,S0432
15,NOTA,None of the Above,16864,99,16963,1.55,S0432
1,NAVEEN JINDAL,Bharatiya Janata Party,540677,1498,542175,44.96,S072
2,DR SUSHIL GUPTA,Aam Aadmi Party,511770,1384,513154,42.55,S072
3,ABHAY SINGH CHAUTALA,Indian National Lok Dal,78362,346,78708,6.53,S072
4,DEEPAK MEHRA,Bahujan Samaj Party,20864,80,20944,1.74,S072
5,JAI KUMAR  SAINI HAMIDPUR,Independent,8090,3,8093,0.67,S072
6,PALA RAM SAINI,Jannayak Janta Party,6159,23,6182,0.51,S072
7,SATBIR KASHYAP,Rashtriya Janshakti Party(Eklavya),3251,12,3263,0.27,S072
8,KHAZAN SINGH SEHGAL,Shiromani Akali Dal (Amritsar)(Simranjit Singh Mann),2824,35,2859,0.24,S072
9,MAHAVIR SINGH,Ekam Sanatan Bharat Dal,2779,4,2783,0.23,S072
10,INDERJEET KAMBOJ,Peoples Party of India (Democratic),2107,6,2113,0.18,S072
11,PANDIT ANIL UPADHYAY,Independent,2053,3,2056,0.17,S072
12,ADV ASHWINI SHARMA HRITTWAL,Independent,2027,2,2029,0.17,S072
13,COMRADE OM PARKASH SHASTRI,Socialist Unity Centre Of India (COMMUNIST),1806,6,1812,0.15,S072
14,SURENDER SINGH,Independent,1599,0,1599,0.13,S072
15,AMIT MALIK,Independent,1503,3,1506,0.12,S072
16,PATASHO DEVI EX-SARPANCH,Independent,1379,0,1379,0.11,S072
17,DR MAHESH CHAND GAUR,Independent,1338,2,1340,0.11,S072
18,JAI PARKASH SHARMA,Independent,1152,2,1154,0.1,S072
19,VARUN GUPTA,Independent,1129,5,1134,0.09,S072
20,SATNAM BHAZIGAR,Loktantrik Lok Rajyam Party,1063,3,1066,0.09,S072
21,NARESH KUMAR,Samata Party,1028,4,1032,0.09,S072
22,SATISH DHULL,Bharatiya Asha Party,991,6,997,0.08,S072
23,ADVOCATE PARDEEP SAINI,Rashtriya Garib Dal,958,2,960,0.08,S072
24,SEWA SINGH,Independent,717,1,718,0.06,S072
25,ER VISHAL KUMAR,Independent,715,0,715,0.06,S072
26,COMRADE RAMESH KHATKAR,Independent,714,3,717,0.06,S072
27,OM PARKASH INDAL,Global Republican Party,675,3,678,0.06,S072
28,PHOOL SINGH,Independent,625,1,626,0.05,S072
29,SUNNY KASHYAP TEORA,Independent,576,0,576,0.05,S072
30,RAMDIYA,Independent,553,3,556,0.05,S072
31,MANGAT RAM,Independent,509,0,509,0.04,S072
32,NOTA,None of the Above,2420,19,2439,0.2,S072
1,AVIMANYU SETHI,Bharatiya Janata Party,569705,3614,573319,44.19,S187
2,MANJULATA MANDAL,Biju Janata Dal,480105,1670,481775,37.13,S187
3,ANANTA PRASAD SETHI,Indian National Congress,221020,854,221874,17.1,S187
4,KIRTAN BIHARI MALIK,Socialist Unity Centre Of India (COMMUNIST),4879,1,4880,0.38,S187
5,ADV. ARJUN CHARAN MALLIK,Bahujan Samaj Party,3581,23,3604,0.28,S187
6,ANJAN DAS,Ambedkarite Party of India,3512,5,3517,0.27,S187
7,BASANTA KUMAR MAHALIK,Independent,1527,3,1530,0.12,S187
8,SARBESWAR BEHERA,Independent,1397,3,1400,0.11,S187
9,NOTA,None of the Above,5457,21,5478,0.42,S187
1,MITESH PATEL (BAKABHAI),Bharatiya Janata Party,607394,5090,612484,52.44,S0616
2,AMIT CHAVDA,Indian National Congress,516453,6092,522545,44.74,S0616
3,SURESHBHAI DHULABHAI PATEL,Bahujan Samaj Party,5778,53,5831,0.5,S0616
4,BHOI ASHISHKUMAR THAKORBHAI,Independent,5525,17,5542,0.47,S0616
5,KEYURBHAI PRAVINBHAI PATEL (BAKABHAI),Independent,2290,8,2298,0.2,S0616
6,DHEERAJKUMAR KSHATRIYA,Garib Kalyan Party,1723,24,1747,0.15,S0616
7,BHATT SUNILKUMAR NARENDRABHAI,Right to Recall Party,1584,8,1592,0.14,S0616
8,NOTA,None of the Above,15679,251,15930,1.36,S0616
1,APARAJITA SARANGI,Bharatiya Janata Party,509567,2952,512519,47.36,S1818
2,MANMATH KUMAR ROUTRAY,Biju Janata Dal,475990,1377,477367,44.11,S1818
3,SYED YASHIR NAWAZ,Indian National Congress,66045,317,66362,6.13,S1818
4,SURESH CHANDRA PANIGRAHY,Communist Party of India  (Marxist),4134,14,4148,0.38,S1818
5,HULAS SENAPATI,Independent,2248,3,2251,0.21,S1818
6,KISHOR KUMAR SUTAR,Independent,2202,1,2203,0.2,S1818
7,SUDHANSU SEKHAR DAS,Independent,1751,7,1758,0.16,S1818
8,SANTOSH KUMAR MISHRA,Independent,1738,6,1744,0.16,S1818
9,SANGEETA PATTANAIK,Odisha Janata Party,1528,2,1530,0.14,S1818
10,PRADEEP KUMAR SAHOO,Kalinga Sena,1495,8,1503,0.14,S1818
11,SANTILATA ROUT,Supreme Zero Party of Bharat,1437,4,1441,0.13,S1818
12,NATABAR MAHARANA,Bharatiya Bikash Parishad,1080,7,1087,0.1,S1818
13,NOTA,None of the Above,8261,41,8302,0.77,S1818
1,RAKIBUL HUSSAIN,Indian National Congress,1468549,3336,1471885,59.99,S032
2,MOHAMMED BADRUDDIN AJMAL,All India United Democratic Front,458202,1207,459409,18.72,S032
3,ZABED ISLAM,Asom Gana Parishad,435822,2772,438594,17.88,S032
4,S. M. JIAUL HAQUE,Bharatiya Gana Parishad,11978,128,12106,0.49,S032
5,FARUK KHAN,Independent,10986,8,10994,0.45,S032
6,BISWAJIT RAY,Independent,7615,88,7703,0.31,S032
7,ALAKESH ROY,Independent,6950,40,6990,0.28,S032
8,HAFIZ BURHANUDDIN,The National Road Map Party of India,6934,6,6940,0.28,S032
9,RADHARANI BISWAS,Hindu Samaj Party,6137,150,6287,0.26,S032
10,TAHIDUR RAHMAN,Voters Party  International,5384,8,5392,0.22,S032
11,SHUKUR ALI,Asom Jana Morcha,4749,43,4792,0.2,S032
12,SURAT ZAMAN MONDAL,Socialist Unity Centre Of India (COMMUNIST),3984,31,4015,0.16,S032
13,REJAUL KARIM,Republican Party of India (Athawale),3481,5,3486,0.14,S032
14,NOTA,None of the Above,14912,103,15015,0.61,S032
1,GUMMA THANUJA RANI,Yuvajana Sramika Rythu Congress Party,471470,5535,477005,40.96,S011
2,KOTHAPALLI GEETHA,Bharatiya Janata Party,417113,9312,426425,36.62,S011
3,APPALANARASA PACHIPENTA,Communist Party of India  (Marxist),119016,4113,123129,10.57,S011
4,AVASHYA LAHARI . VARAM,Bahujan Samaj Party,24858,892,25750,2.21,S011
5,SAMAREDDY BALAKRISHNA,Independent,9493,42,9535,0.82,S011
6,NIMMAKA JAYARAJU,Independent,8798,664,9462,0.81,S011
7,ATHIDHI,Independent,8121,15,8136,0.7,S011
8,CHANTI BADNAINA,Jai Bharat National Party,7205,47,7252,0.62,S011
9,MOTTADAM . RAJABABU,Bharat Adivasi Party,6370,396,6766,0.58,S011
10,RANJITH KUMAR PALAKA,Independent,6000,47,6047,0.52,S011
11,RAMBABU JALLI,Telugu Rajadhikara Samiti Party,4933,26,4959,0.43,S011
12,MANDALA GIRIDHARA RAO,Independent,4931,36,4967,0.43,S011
13,VUYAKA NIREEKSHAN  (V. CHENCHU),India Praja Bandhu Party,4500,42,4542,0.39,S011
14,NOTA,None of the Above,50205,265,50470,4.33,S011
1,SANGEETA KUMARI SINGH DEO,Bharatiya Janata Party,614196,3548,617744,44.12,S1810
2,SURENDRA SINGH BHOI,Biju Janata Dal,483964,1116,485080,34.64,S1810
3,MANOJ KUMAR MISHRA,Indian National Congress,229577,1297,230874,16.49,S1810
4,SUNIL KUMAR BHOI,Socialist Unity Centre Of India (COMMUNIST),10334,21,10355,0.74,S1810
5,JAGADISH CHANDRA BIBHAR,Bahujan Samaj Party,9404,65,9469,0.68,S1810
6,BALRAM SINGH YADAV,Independent,8637,37,8674,0.62,S1810
7,MADHUSUDAN BARIK,Ambedkarite Party of India,7239,13,7252,0.52,S1810
8,BALARAM SA,Independent,6092,5,6097,0.44,S1810
9,AKSHAYA DISHRI,National Apni Party,5465,4,5469,0.39,S1810
10,RAJESH KUMAR PANDA,Ekam Sanatan Bharat Dal,3163,7,3170,0.23,S1810
11,NOTA,None of the Above,16010,54,16064,1.15,S1810
1,KRISHAN PAL,Bharatiya Janata Party,787332,1237,788569,53.6,S0710
2,MAHENDER PRATAP SINGH,Indian National Congress,614908,747,615655,41.84,S0710
3,KISHAN THAKUR,Bahujan Samaj Party,25164,42,25206,1.71,S0710
4,SUNIL TEWATIA,Indian National Lok Dal,8057,28,8085,0.55,S0710
5,NALIN HOODA,Jannayak Janta Party,5335,26,5361,0.36,S0710
6,SAWATANTAR SINGH CHAUHAN,Jan Shakti Dal,2951,4,2955,0.2,S0710
7,NEERAJ JATAV,Independent,2104,4,2108,0.14,S0710
8,HARI SHANKER RAJVANS,Adim Bhartiya Dal,1584,0,1584,0.11,S0710
9,ATUL,Independent,1456,2,1458,0.1,S0710
10,PANDIT SUMIT KUMAR SHARMA,AARAKSHAN VIRODHI PARTY,1439,5,1444,0.1,S0710
11,BRIJABALA,Peoples Party of India (Democratic),1370,10,1380,0.09,S0710
12,SHYAM SUNDER SINGH,Bhartiya Shakti Chetna Party,1247,0,1247,0.08,S0710
13,MAHESH PRATAP SHARMA,Rashtriya Vikas Party,1237,3,1240,0.08,S0710
14,SATAY DEO YADAV,Buland Bharat Party,953,2,955,0.06,S0710
15,RANDHEER SINGH ALIAS DHEERU KHATANA,Akhil Bhartiya Kisan Majdoor Party,919,5,924,0.06,S0710
16,SUNIL KUMAR,Independent,888,1,889,0.06,S0710
17,BHARAT BHUSHAN KOLI,Rashtra Nirman Party,807,1,808,0.05,S0710
18,SHIV NARAYAN BABA DUBEY,Kisan Mazdoor Sangharsh Party,769,2,771,0.05,S0710
19,GYAN CHAND BAINSLA,Samrat Mihir Bhoj Samaj Party,751,5,756,0.05,S0710
20,RAJESH GAUTAM,Independent,662,1,663,0.05,S0710
21,SWAMI RAJENDRA DEV JI,Independent,660,3,663,0.05,S0710
22,GIRRAJ,Independent,612,2,614,0.04,S0710
23,LEKHRAM DABANG,Independent,610,5,615,0.04,S0710
24,SHAKILA HUSSAIN,Loktantrik Janshakti Party,547,4,551,0.04,S0710
25,NOTA,None of the Above,6808,13,6821,0.46,S0710
1,SAVITRI THAKUR,Bharatiya Janata Party,792591,1858,794449,55.75,S1225
2,RADHESHYAM MUVEL,Indian National Congress,574756,1028,575784,40.4,S1225
3,DHUMSINGH MANDLOI MACHHAR,Bahujan Samaj Party,14926,30,14956,1.05,S1225
4,JITENDRA MUNIYA,Bharat Adivasi Party,10586,35,10621,0.75,S1225
5,SUNIL AJRAWAT,Independent,5400,8,5408,0.38,S1225
6,SHIVAJI PATEL KALMI,Independent,4694,6,4700,0.33,S1225
7,VIKRAM VASUNIYA,Janata Congress,3464,11,3475,0.24,S1225
8,NOTA,None of the Above,15612,39,15651,1.1,S1225
1,DELKAR KALABEN MOHANBHAI,Bharatiya Janata Party,120833,241,121074,58.89,U032
2,AJIT RAMJIBHAI MAHALA,Indian National Congress,63423,67,63490,30.88,U032
3,KURADA DEEPAKBHAI,Bharat Adivasi Party,10188,9,10197,4.96,U032
4,BORSA SANDIPBHAI S,Bahujan Samaj Party,3147,5,3152,1.53,U032
5,SHAILESHBHAI VARTHA,Independent,2522,2,2524,1.23,U032
6,NOTA,None of the Above,5144,7,5151,2.51,U032
1,UMMEDA RAM BENIWAL,Indian National Congress,699122,5554,704676,41.74,S2017
2,RAVINDRA SINGH BHATI,Independent,581865,4635,586500,34.74,S2017
3,KAILASH CHOUDHARY,Bharatiya Janata Party,284527,2206,286733,16.99,S2017
4,TARARAM MEHNA,Independent,49768,189,49957,2.96,S2017
5,PRATAPA RAM,Independent,8282,36,8318,0.49,S2017
6,HANIPH,Independent,7755,5,7760,0.46,S2017
7,LEELA RAM,Bahujan Samaj Party,7557,28,7585,0.45,S2017
8,PRABHU RAM,Aazad Samaj Party (Kanshi Ram),6381,15,6396,0.38,S2017
9,RAMA RAM,Independent,6031,10,6041,0.36,S2017
10,POPAT LAL,Independent,3117,42,3159,0.19,S2017
11,DEVILAL JAIN,Independent,3016,7,3023,0.18,S2017
12,NOTA,None of the Above,17893,10,17903,1.06,S2017
1,SUKHJINDER SINGH RANDHAWA,Indian National Congress,361713,2330,364043,33.78,S191
2,DINESH SINGH BABBU,Bharatiya Janata Party,278701,2481,281182,26.09,S191
3,AMANSHER SINGH (SHERY KALSI),Aam Aadmi Party,275416,1836,277252,25.72,S191
4,DR. DALJIT SINGH CHEEMA,Shiromani Akali Dal,85194,306,85500,7.93,S191
5,GURINDER SINGH BAJWA,Shiromani Akali Dal (Amritsar)(Simranjit Singh Mann),25425,340,25765,2.39,S191
6,SANT SEWAK,Independent,5950,2,5952,0.55,S191
7,RAJ KUMAR,Bahujan Samaj Party,4859,71,4930,0.46,S191
8,SANTOSH KAUR,Independent,4733,5,4738,0.44,S191
9,SAMUEL SONI,Independent,4427,13,4440,0.41,S191
10,SURJIT SINGH,Independent,3372,1,3373,0.31,S191
11,SANJEEV SINGH,Independent,2172,6,2178,0.2,S191
12,SURINDER SINGH,Independent,1775,7,1782,0.17,S191
13,GURPREET KAUR BAJWA,Independent,1688,21,1709,0.16,S191
14,SANJEEV MANHAS,Independent,1634,1,1635,0.15,S191
15,ROBI MASIH,Independent,1509,2,1511,0.14,S191
16,SANTOSH KUMARI,Megh Desham Party,1171,23,1194,0.11,S191
17,RAMESH KUMAR TOLLA,Bharatheeya Jawan Kisan Party,1085,13,1098,0.1,S191
18,AMIT AGGARWAL,Independent,920,4,924,0.09,S191
19,TARSEM MASIH SAHOTA,Independent,878,7,885,0.08,S191
20,TILAK RAJ,Independent,802,3,805,0.07,S191
21,RANJODH SINGH,Jan Sewa Driver Party,776,13,789,0.07,S191
22,I.S.GULATI,Independent,696,3,699,0.06,S191
23,RAMESH LAL,National Republic Party Of India,653,4,657,0.06,S191
24,JAGDISH MASIH,Independent,545,1,546,0.05,S191
25,JATINDER KUMAR SHARMA,Bhartiya Rashtriya Dal,456,5,461,0.04,S191
26,DARBARA SINGH,Nationalist Justice Party,415,9,424,0.04,S191
27,NOTA,None of the Above,3289,65,3354,0.31,S191
1,JAGADISH SHETTAR,Bharatiya Janata Party,756471,5558,762029,55.06,S102
2,MRINAL R HEBBALKAR,Indian National Congress,580897,2695,583592,42.17,S102
3,MAHADEV PATIL,Independent,9425,78,9503,0.69,S102
4,BASAPPA GURUSIDDAPPA KUMBAR,Karnataka Rashtra Samithi,5406,35,5441,0.39,S102
5,ASHOK APPAYA APPUGOL,Bahujan Samaj Party,4350,57,4407,0.32,S102
6,RAVI SHIVAPPA PADASALAGI,Independent,3911,15,3926,0.28,S102
7,VIJAY S METHRANI,Independent,2804,4,2808,0.2,S102
8,PRAJAAKEEYA MALLAPPA CHOGALA (PREM),Uttama Prajaakeeya Party,1413,20,1433,0.1,S102
9,LAXMAN JADAGANNAVAR,Socialist Unity Centre Of India (COMMUNIST),1287,15,1302,0.09,S102
10,NITIN ASHOK MHADAGUT,Independent,1286,24,1310,0.09,S102
11,PUNDALIK ITNAL,Independent,1062,37,1099,0.08,S102
12,ASHOK P HANAJI,Independent,668,11,679,0.05,S102
13,ASHPAKAHMAD USTAD,Independent,622,12,634,0.05,S102
14,NOTA,None of the Above,5683,43,5726,0.41,S102
1,SANATAN PANDEY,Samajwadi Party,464473,2595,467068,46.37,S2472
2,NEERAJ SHEKHAR,Bharatiya Janata Party,421277,2407,423684,42.06,S2472
3,LALLAN SINGH YADAV,Bahujan Samaj Party,84943,262,85205,8.46,S2472
4,SUMESHWAR,Independent,5056,0,5056,0.5,S2472
5,SHESHNATH,Independent,3587,1,3588,0.36,S2472
6,RAVI KANT SINGH ALIAS RAVI PATEL,Sardar Patel Siddhant Party,3174,7,3181,0.32,S2472
7,RAMNIVAS GOND,Gondvana Gantantra Party,2642,30,2672,0.27,S2472
8,SURYA BALI PRASAD,Aazad Samaj Party (Kanshi Ram),2143,5,2148,0.21,S2472
9,RANJANA,Independent,1871,7,1878,0.19,S2472
10,ASHOK GUPTA,Independent,1339,8,1347,0.13,S2472
11,MANINDR,Independent,1186,1,1187,0.12,S2472
12,AVADHESH VERMA,Independent,1150,11,1161,0.12,S2472
13,PRAKASH KUMAR,Independent,960,0,960,0.1,S2472
14,NOTA,None of the Above,8167,20,8187,0.81,S2472
1,DR C N MANJUNATH,Bharatiya Janata Party,1075553,3449,1079002,56.21,S1023
2,D K SURESH,Indian National Congress,807459,1896,809355,42.16,S1023
3,ABHISHEK K,Uttama Prajaakeeya Party,6191,11,6202,0.32,S1023
4,SURESH M N,Independent,3231,5,3236,0.17,S1023
5,HEMAVATHI K,Socialist Unity Centre Of India (COMMUNIST),1768,6,1774,0.09,S1023
6,J T PRAKASH,Independent,1468,4,1472,0.08,S1023
7,N KRISHNAPPA,Pyramid Party of India,1396,6,1402,0.07,S1023
8,C N MANJUNATHA,Bahujan Bharat Party,1350,50,1400,0.07,S1023
9,KUMAR L,Bharatiya Prajagala Kalyana Paksha,1052,14,1066,0.06,S1023
10,MAHAMAD MUSADIK PASHA,Karnataka Rashtra Samithi,817,4,821,0.04,S1023
11,NARASIMHAMURTHY J P,Independent,809,4,813,0.04,S1023
12,SURESH S,Karunaadu Party,792,6,798,0.04,S1023
13,VASIST J,Country Citizen Party,546,38,584,0.03,S1023
14,MOHAMMAD DASTAGEER,Young Star Empowerment Party,486,0,486,0.03,S1023
15,H V CHANDRASHEKAR,Viduthalai Chiruthaigal Katchi,473,7,480,0.03,S1023
16,NOTA,None of the Above,10633,16,10649,0.55,S1023
1,C.M.RAMESH,Bharatiya Janata Party,750027,12042,762069,57.5,S015
2,BUDI MUTYALA NAIDU,Yuvajana Sramika Rythu Congress Party,459762,5777,465539,35.13,S015
3,VEGI VENKATESH,Indian National Congress,24833,818,25651,1.94,S015
4,PALAKA SREERAMA MURTHY,Bahujan Samaj Party,19082,75,19157,1.45,S015
5,VANKAYALA RAMACHANDRA RAO,Independent,4001,1,4002,0.3,S015
6,LOVARAJU SIDDHA,Independent,3845,7,3852,0.29,S015
7,KRISHNA SWAROOP VADLAMURI,Dalita Bahujana Party,3549,8,3557,0.27,S015
8,GARA SURYA RAO,Independent,3116,8,3124,0.24,S015
9,APPALA RAJU NAMMI,Bharatha Chaitanya Yuvajana Party,2589,30,2619,0.2,S015
10,NAGESWARA RAO PETLA,Independent,2179,5,2184,0.16,S015
11,ADARI SARAT CHANDRA,Jai Bharat National Party,1886,27,1913,0.14,S015
12,VIJAYA LAKSHMI KARRI,Pyramid Party of India,1578,13,1591,0.12,S015
13,DR. THUMMAPALA HARI  SHANKAR,Independent,1567,9,1576,0.12,S015
14,JUNNURI J SRINIVAS,Independent,1195,6,1201,0.09,S015
15,APPALANAIDU TUMMAGUNTA,Independent,1055,7,1062,0.08,S015
16,NOTA,None of the Above,26084,151,26235,1.98,S015
1,PRADEEP PUROHIT,Bharatiya Janata Party,709606,6753,716359,54.69,S181
2,PARINITA MISHRA,Biju Janata Dal,463008,1684,464692,35.48,S181
3,SANJAY BHOI,Indian National Congress,92666,885,93551,7.14,S181
4,JAYARAM BAGH,Bahujan Samaj Party,9215,107,9322,0.71,S181
5,GNYANENDRA BEHERA,Independent,4539,24,4563,0.35,S181
6,DEVIKA SIKA,National Apni Party,4524,14,4538,0.35,S181
7,PRABHAT KUMAR DHARUA,Independent,4294,4,4298,0.33,S181
8,NOTA,None of the Above,12414,127,12541,0.96,S181
1,Y. S. AVINASH REDDY,Yuvajana Sramika Rythu Congress Party,598406,6737,605143,45.78,S0121
2,CHADIPIRALLA BHUPESH SUBBARAMI REDDY,Telugu Desam,532358,10090,542448,41.03,S0121
3,Y.S. SHARMILA REDDY,Indian National Congress,136395,4644,141039,10.67,S0121
4,PANDITI. GURAPPA.,Bahujan Samaj Party,3790,20,3810,0.29,S0121
5,VENU GOPAL RACHINENI,Rashtriya Praja Congress  (Secular),3500,70,3570,0.27,S0121
6,CHINNAPUREDDY GOPALA KRISHNA REDDY,Independent,2414,16,2430,0.18,S0121
7,KUNCHAM. VENKATA SUBBA REDDY,Rayalaseema Rashtra Samithi,2329,4,2333,0.18,S0121
8,L. KHAJA HUSSAIN,Independent,1087,1,1088,0.08,S0121
9,ANKIREDDY. SURESH KUMAR REDDY.,All India Forward Bloc,752,3,755,0.06,S0121
10,KAKARLA SHANMUKHA REDDY,Independent,633,14,647,0.05,S0121
11,PALLE RAMESH,Jaibhim Rao Bharat Party,619,5,624,0.05,S0121
12,CHAN BASHA. S,Anna YSR Congress Party,432,7,439,0.03,S0121
13,J. V. RAMANA,Jaathia Chethi Vruthula Ikya Vedika Party,414,20,434,0.03,S0121
14,MALIKIREDDY. HANUMANTHA REDDY,Jana Sahayaka Sakthi,358,11,369,0.03,S0121
15,NOTA,None of the Above,16660,186,16846,1.27,S0121
1,ESWARASAMY K,Dravida Munnetra Kazhagam,530742,2635,533377,47.37,S2221
2,KARTHIKEYAN A,All India Anna Dravida Munnetra Kazhagam,280230,1105,281335,24.98,S2221
3,VASANTHARAJAN K,Bharatiya Janata Party,221945,1409,223354,19.84,S2221
4,SURESHKUMAR N,Naam Tamilar Katchi,57962,234,58196,5.17,S2221
5,PRAKASH P,Independent,2834,17,2851,0.25,S2221
6,BENJAMINKIRUBAKARAN J,Bahujan Samaj Party,2267,17,2284,0.2,S2221
7,VASANTHAKUMAR T,Independent,2186,4,2190,0.19,S2221
8,RAMASAMY K,Independent,1816,9,1825,0.16,S2221
9,ESWARASAMY K,Independent,1775,15,1790,0.16,S2221
10,GOPALAKRISHNAN M,New Generation People’s Party,1127,6,1133,0.1,S2221
11,KALIMUTHU S,Independent,976,5,981,0.09,S2221
12,KARTHIKEYAN D,Independent,600,19,619,0.05,S2221
13,NOOR MUHAMAD A,Independent,599,6,605,0.05,S2221
14,KARTHIKEYAN P,Independent,548,19,567,0.05,S2221
15,KARTHIKEYAN D,Independent,433,2,435,0.04,S2221
16,NOTA,None of the Above,14399,104,14503,1.29,S2221
1,DHARMENDRA PRADHAN,Bharatiya Janata Party,587827,4335,592162,49.48,S183
2,PRANAB PRAKASH DAS,Biju Janata Dal,471198,1128,472326,39.47,S183
3,NAGENDRA KUMAR PRADHAN,Indian National Congress,88573,540,89113,7.45,S183
4,SADANAND RANBIDA,Bahujan Samaj Party,4776,19,4795,0.4,S183
5,SRIRAM PANDEY,Independent,4700,2,4702,0.39,S183
6,SHUSHIL KUMAR BABU,Independent,4298,5,4303,0.36,S183
7,GNYANENDRA BEHERA,Independent,3331,3,3334,0.28,S183
8,NABAKISHORE PRADHAN,Socialist Unity Centre Of India (COMMUNIST),3151,6,3157,0.26,S183
9,ATMA RAM SUPKAR,Independent,2053,6,2059,0.17,S183
10,PURUSHOTTAM PATRA,Kosal Janata Dal,1731,4,1735,0.14,S183
11,RAKESH BAG,Bharatiya Nyay-Adhikar Raksha Party,1704,4,1708,0.14,S183
12,SUBASH MOHAPATRA,National Jan Dal,1669,24,1693,0.14,S183
13,LAXMAN KUMAR BHOI,Paschimanchal Vikas Party,1662,20,1682,0.14,S183
14,KHAGESWAR BEHERA,Rashtriya Manav Party,1492,3,1495,0.12,S183
15,NOTA,None of the Above,12451,32,12483,1.04,S183
1,ARUN GOVIL,Bharatiya Janata Party,544375,2094,546469,46.21,S2410
2,SUNITA VERMA,Samajwadi Party,535009,875,535884,45.32,S2410
3,DEVVRAT KUMAR TYAGI,Bahujan Samaj Party,86693,332,87025,7.36,S2410
4,BHUPENDRA PAL URF BHUPPI BHAI,Rashtriya Shoshit Samaj Party,2615,11,2626,0.22,S2410
5,HAJI  AFZAL,Sabse Achchhi Party,2026,3,2029,0.17,S2410
6,ABID HUSAIN,Social Democratic Party Of India,1917,5,1922,0.16,S2410
7,LIYAKAT,Majloom Samaj Party,891,3,894,0.08,S2410
8,DR HIMANSHU BHATNAGAR,Jai Hind National Party,848,6,854,0.07,S2410
9,NOTA,None of the Above,4738,38,4776,0.4,S2410
1,DR. PRABHA MALLIKARJUN,Indian National Congress,631453,1606,633059,47.95,S1013
2,GAYITHRI SIDDESHWARA,Bharatiya Janata Party,604531,2434,606965,45.97,S1013
3,G.B.VINAY KUMAR,Independent,42624,283,42907,3.25,S1013
4,T.JABEENA AAPA,Independent,5127,1,5128,0.39,S1013
5,D. HANUMANTHAPPA,Bahujan Samaj Party,4462,13,4475,0.34,S1013
6,TASLIM BANU,Independent,4140,1,4141,0.31,S1013
7,T.CHANDRU,Independent,3043,0,3043,0.23,S1013
8,G.M.GAYITRI SIDDESHI,Independent,2453,11,2464,0.19,S1013
9,PARAVEEJ.H,Independent,1867,2,1869,0.14,S1013
10,ESHWARA SHENGA,Uttama Prajaakeeya Party,1424,6,1430,0.11,S1013
11,A.K.GANESH,Independent,1054,1,1055,0.08,S1013
12,M.C.SREENIVAS,Bharatiya Prajagala Kalyana Paksha,968,5,973,0.07,S1013
13,SYED ZABIULLA.K,Independent,843,1,844,0.06,S1013
14,ANABERU THIPPESWAMY,Socialist Unity Centre Of India (COMMUNIST),842,7,849,0.06,S1013
15,SALEEM S,Independent,799,0,799,0.06,S1013
16,MOHAMED HAYATH.M,Independent,721,1,722,0.05,S1013
17,ABDUL NAZEER AHAMMED,Independent,651,1,652,0.05,S1013
18,RASHEED KHAN,Independent,599,1,600,0.05,S1013
19,M.G.SRIKANTH,Navabharath Sena,555,6,561,0.04,S1013
20,M.P. KHALANDAR,Country Citizen Party,536,3,539,0.04,S1013
21,PEDDAPPA S,Independent,506,2,508,0.04,S1013
22,G.M.BARKATH ALI BASHA,Independent,470,1,471,0.04,S1013
23,K.S. VEERBHADRAPPA,Karnataka Rashtra Samithi,466,9,475,0.04,S1013
24,VEERESH.S (LION VEERESH),Rani Chennamma Party,457,1,458,0.03,S1013
25,DODDESH.H.S,Janahitha Paksha,439,1,440,0.03,S1013
26,BARKATH ALI,Independent,409,2,411,0.03,S1013
27,MANJU. MARIKOPPA,Independent,376,2,378,0.03,S1013
28,RUDRESHA.K.H,Samaj Vikas Kranti Party,346,2,348,0.03,S1013
29,RAVINAIK. B,Independent,317,3,320,0.02,S1013
30,MAHABUB BASHA,Independent,308,0,308,0.02,S1013
31,NOTA,None of the Above,3165,11,3176,0.24,S1013
1,SELVAGANAPATHI T M,Dravida Munnetra Kazhagam,562022,4063,566085,43.38,S2215
2,VIGNESH P,All India Anna Dravida Munnetra Kazhagam,492958,2770,495728,37.99,S2215
3,ANNADURAI N,Pattali Makkal Katchi,125829,1310,127139,9.74,S2215
4,DR MANOJKUMAR G,Naam Tamilar Katchi,75636,571,76207,5.84,S2215
5,BHALAJI M,Independent,3437,4,3441,0.26,S2215
6,MURALI S,Bahujan Samaj Party,3333,39,3372,0.26,S2215
7,PALANIVEL K,Independent,2853,3,2856,0.22,S2215
8,JEGANNATHAN A,Independent,2384,27,2411,0.18,S2215
9,RAJA S,Independent,1442,14,1456,0.11,S2215
10,MUTHUSAMY S,Independent,1193,4,1197,0.09,S2215
11,ER PRABAKARAN S,Independent,1151,4,1155,0.09,S2215
12,SHANMUGAM G,Independent,1144,3,1147,0.09,S2215
13,SANTHALINGAM C,Independent,1079,19,1098,0.08,S2215
14,SUTHARSANAM S,Aravor Munnetra Kazhagam,1030,6,1036,0.08,S2215
15,AMBEDKAR C,Ambedkarite Party of India,944,17,961,0.07,S2215
16,RAMACHANDRAN C,Dhesiya Makkal Kazhagam,748,10,758,0.06,S2215
17,GOVINDHAN A,Independent,686,7,693,0.05,S2215
18,MANICKAM R,Ulzaipali Makkal Katchy,533,4,537,0.04,S2215
19,AHAMED SHAHJAHAN M,Independent,453,13,466,0.04,S2215
20,INTHRAJITHKUPTHA G,Independent,425,7,432,0.03,S2215
21,RAMASUNDARAM D,Independent,419,3,422,0.03,S2215
22,KARUNAKARAN M,Independent,359,18,377,0.03,S2215
23,RAJA A,Independent,329,3,332,0.03,S2215
24,VIGNESH M,Independent,324,4,328,0.03,S2215
25,JOTHILINGAM M,Independent,314,2,316,0.02,S2215
26,NOTA,None of the Above,14677,217,14894,1.14,S2215
1,ANUPRIYA PATEL,Apna Dal (Soneylal),470866,765,471631,42.67,S2479
2,RAMESH CHAND BIND,Samajwadi Party,433286,535,433821,39.25,S2479
3,MANISH KUMAR,Bahujan Samaj Party,144279,167,144446,13.07,S2479
4,RAJESH,Independent,10927,9,10936,0.99,S2479
5,LAL JI VERMA,Independent,6355,4,6359,0.58,S2479
6,ANIL KUMAR,Eklavya Samaj Party,6166,5,6171,0.56,S2479
7,DAULAT SINGH,Apna Dal (Kamerawadi),5227,8,5235,0.47,S2479
8,RAMDHANI,Rashtriya Samaj Paksha,4914,1,4915,0.44,S2479
9,SAMEER SINGH,All India Forward Bloc,3486,1,3487,0.32,S2479
10,SATYADEV,Purvanchal Mahapanchayat,3351,4,3355,0.3,S2479
11,NOTA,None of the Above,15043,6,15049,1.36,S2479
1,BIRENDRA SINGH,Samajwadi Party,472928,1548,474476,42.5,S2476
2,DR. MAHENDRA NATH  PANDEY,Bharatiya Janata Party,451802,1109,452911,40.57,S2476
3,SATYENDRA KUMAR MAURYA,Bahujan Samaj Party,159585,318,159903,14.32,S2476
4,SHOBHANATH  PRAJAPATI,Bhagidari Party(P),4027,5,4032,0.36,S2476
5,SHER SINGH,Yuga Thulasi Party,3090,6,3096,0.28,S2476
6,SANTOSH KUMAR,Independent,2965,4,2969,0.27,S2476
7,RAJESH VISHWAKARMA,Moulik Adhikar Party,2759,3,2762,0.25,S2476
8,ARVIND KUMAR PATEL,Sardar Patel Siddhant Party,2734,11,2745,0.25,S2476
9,SANJAY KUMAR SINHA,Jai Hind National Party,2617,6,2623,0.23,S2476
10,RAM GOVIND,Samajhdar Party,1975,2,1977,0.18,S2476
11,NOTA,None of the Above,8987,18,9005,0.81,S2476
1,DR. KIRSAN  NAMDEO,Indian National Congress,614610,3182,617792,52.97,S1312
2,ASHOK  MAHADEORAO NETE,Bharatiya Janata Party,474376,1720,476096,40.82,S1312
3,GONNADE  YOGESH  NAMDEORAO,Bahujan Samaj Party,18930,125,19055,1.63,S1312
4,HITESH PANDURANG MADAVI,Vanchit Bahujan  Aaghadi,15824,98,15922,1.37,S1312
5,VINOD GURUDAS MADAVI,Independent,6107,19,6126,0.53,S1312
6,KODAPE VILAS SHAMARAO,Independent,4396,6,4402,0.38,S1312
7,SUHAS UMESH KUMRE,Bhim Sena,2851,21,2872,0.25,S1312
8,KARAN SURESH SAYAM,Independent,2772,17,2789,0.24,S1312
9,BARIKRAO DHARMAJI MADAVI,Bahujan Republican  Socialist Party,2527,28,2555,0.22,S1312
10,DHIRAJ PURUSHOTTAM SHEDMAKE,Janseva Gondwana Party,2141,33,2174,0.19,S1312
11,NOTA,None of the Above,16507,70,16577,1.42,S1312
1,BANSURI SWARAJ,Bharatiya Janata Party,451464,1721,453185,53.48,U054
2,SOMNATH BHARTI,Aam Aadmi Party,374032,783,374815,44.23,U054
3,RAAJ KUMAR ANAND,Bahujan Samaj Party,5601,28,5629,0.66,U054
4,SANJAY RAWAT,Independent,1271,5,1276,0.15,U054
5,ACHLA JETHMALANI,Jindabad Kranti Party,1036,1,1037,0.12,U054
6,HIRA LAL,Independent,1005,0,1005,0.12,U054
7,PREM SINGH,Navarang Congress Party,800,6,806,0.1,U054
8,UPEN‍DRA,Anjaan Aadmi Party,781,0,781,0.09,U054
9,DILIP SINGH,Independent,725,1,726,0.09,U054
10,LUKMAN KHAN,Log Party,654,2,656,0.08,U054
11,PUNAM PANDEY,Rashtravadi Loktantrik Party (India),640,1,641,0.08,U054
12,SANDHYA THAKKAR,Rashtriya Republican Party,485,1,486,0.06,U054
13,RAVINDER SINGH,Independent,414,2,416,0.05,U054
14,DINESH KUMAR,Peoples Party of India (Democratic),360,1,361,0.04,U054
15,PRITHVI NATH SINGH,Bharatiya Sampuran Krantikari Party,335,0,335,0.04,U054
16,MAHESH KUMAR DENWAL,Ambedkarite Party of India,287,1,288,0.03,U054
17,MANOJ KUMAR SHARMA,Loktantrik Janshakti Party,208,4,212,0.03,U054
18,NOTA,None of the Above,4791,22,4813,0.57,U054
1,DILESHWAR KAMAIT,Janata Dal  (United),592922,2116,595038,48.33,S048
2,CHANDRAHAS CHAUPAL,Rashtriya Janata Dal,422037,3198,425235,34.54,S048
3,BAIDYA NATH MEHTA,Independent,51325,327,51652,4.2,S048
4,YOG NARAYAN SINGH,Independent,27447,7,27454,2.23,S048
5,VINDESHWARI PRASAD,Independent,18450,7,18457,1.5,S048
6,KIRAN DEVI,Bahujan Samaj Party,17961,118,18079,1.47,S048
7,MOHD KALIM KHAN,Rashtriya Jansambhavna Party,14064,14,14078,1.14,S048
8,UMESH PRASAD SAH,Jai Hind Party,12971,43,13014,1.06,S048
9,RAJ KUMAR YADAV,Viro Ke Vir Indian Party,10795,11,10806,0.88,S048
10,RAMESH KUMAR ANAND,"Proutist Bloc, India",9439,12,9451,0.77,S048
11,ABDUL MATIN,Independent,7177,17,7194,0.58,S048
12,BAMBAM KUMAR,Independent,7000,6,7006,0.57,S048
13,NITISH KUMAR,Independent,5894,21,5915,0.48,S048
14,AJAY KUMAR SAH,Independent,5330,21,5351,0.43,S048
15,SHIV HARI AGRAWAL,Bharat Nirman Party,3770,2,3772,0.31,S048
16,NOTA,None of the Above,18444,168,18612,1.51,S048
1,MANISH JAISWAL,Bharatiya Janata Party,647416,7197,654613,51.76,S2714
2,JAI PRAKASH BHAI PATEL,Indian National Congress,371641,6286,377927,29.88,S2714
3,SANJAY KUMAR MEHTA,Independent,156298,1679,157977,12.49,S2714
4,SHASHI BHUSHAN KESHRI,Independent,15373,13,15386,1.22,S2714
5,ANIRUDDH KUMAR,Communist Party of India,10428,40,10468,0.83,S2714
6,MD. MOIN UDDIN AHMAD,Bahujan Samaj Party,7395,43,7438,0.59,S2714
7,MD. SERAJ,Independent,5503,3,5506,0.44,S2714
8,VINOD KUMAR RANA,Independent,4831,10,4841,0.38,S2714
9,KUNJ BIHARI KUMAR,Lokhit Adhikar Party,4220,14,4234,0.33,S2714
10,CHHATHI DEVI,Akhil Bhartiya Parivar Party,3296,20,3316,0.26,S2714
11,ABHISHEK KUMAR,Independent,2963,9,2972,0.24,S2714
12,NISHANT KUMAR SINHA,Peoples Party of India (Democratic),2932,24,2956,0.23,S2714
13,MANOJ KUMAR BEDIA,Independent,2559,19,2578,0.2,S2714
14,BHUNESHWAR BEDIYA,Samata Party,2236,28,2264,0.18,S2714
15,RAJ KUMAR,Jharkhand Party,1885,50,1935,0.15,S2714
16,SHYAM BIHARI PRAJAPATI,Bhagidari Party(P),1818,21,1839,0.15,S2714
17,PRAKASH SONI,Bhartiya Azad Sena,1209,8,1217,0.1,S2714
18,NOTA,None of the Above,7090,110,7200,0.57,S2714
1,ANAND BHADAURIYA,Samajwadi Party,442650,1093,443743,39.91,S2429
2,REKHA VERMA,Bharatiya Janata Party,438573,721,439294,39.51,S2429
3,SHYAM KISHOR AWASTHI,Bahujan Samaj Party,184964,510,185474,16.68,S2429
4,JANARDAN PRASAD,Communist Party of India,15898,2,15900,1.43,S2429
5,RAJESH KUMAR,Political Justice Party,5020,3,5023,0.45,S2429
6,ASHUTOSH PATHAK,Aam Janta Party (India),3550,6,3556,0.32,S2429
7,SUDESH KUMAR,Lok Jan Sangharsh Party,2811,3,2814,0.25,S2429
8,SAMRENDRA KUMAR,Independent,2482,2,2484,0.22,S2429
9,VIJAY KUMAR TIWARI,Independent,2017,0,2017,0.18,S2429
10,KASIM ALI,Peace Party,1809,3,1812,0.16,S2429
11,SAKASEN,Sardar Patel Siddhant Party,1295,1,1296,0.12,S2429
12,RAM NARESH,Independent,1290,0,1290,0.12,S2429
13,NOTA,None of the Above,7133,11,7144,0.64,S2429
1,CHANDUBHAI CHHAGANBHAI SHIHORA,Bharatiya Janata Party,664093,5656,669749,59.2,S069
2,RUTVIKBHAI LAVJIBHAI MAKWANA,Indian National Congress,403461,4671,408132,36.07,S069
3,DABHI ASHOKBHAI SUKHABHAI,Bahujan Samaj Party,11885,151,12036,1.06,S069
4,VINODBHAI BABUBHAI SATROTIYA,Independent,5940,6,5946,0.53,S069
5,KOLI RAMESHBHAI VIRSANGBHAI VAGHELA,Independent,5173,16,5189,0.46,S069
6,CHAVDA NILESHBHAI MANSUKHBHAI,Rashtra Nirman Party,4103,26,4129,0.36,S069
7,ZALA DEVRAJBHAI BABUBHAI,Independent,2442,21,2463,0.22,S069
8,J.K.PATEL,Independent,2308,59,2367,0.21,S069
9,DEVENDRA MOHANDAS MAHANT,Gunj Satya Ni Janata Party,2042,9,2051,0.18,S069
10,GEDIYA KRUSHANAVADAN HARIPRASADBHAI,Independent,1435,24,1459,0.13,S069
11,ANANDBHAI PACHANBHAI RATHOD,Independent,1241,8,1249,0.11,S069
12,DILIPBHAI PARSHOTTAMBHAI MAKWANA,New India United Party,1222,35,1257,0.11,S069
13,ASHOK PALAJIBHAI RATHOD,Independent,1087,4,1091,0.1,S069
14,PATEL MADHUSUDAN BALDEVBHAI,Mission All India Independent Justice Party,948,12,960,0.08,S069
15,NOTA,None of the Above,12799,500,13299,1.18,S069
1,VENKATESAN S,Communist Party of India  (Marxist),428201,2122,430323,43.6,S2232
2,RAAMA SREENIVASAN,Bharatiya Janata Party,219035,1879,220914,22.38,S2232
3,SARAVANAN P,All India Anna Dravida Munnetra Kazhagam,204163,641,204804,20.75,S2232
4,SATHYADEVI T,Naam Tamilar Katchi,92386,493,92879,9.41,S2232
5,VELMURUGAN A,Bharatiya Praja Aikyata Party,5966,43,6009,0.61,S2232
6,VENKATESAN M,Independent,2497,8,2505,0.25,S2232
7,RAMAR PANDI T,Bahujan Samaj Party,2489,17,2506,0.25,S2232
8,SHANMUGA SUNDARAM A,United Republican Party of India,2338,11,2349,0.24,S2232
9,PERIYASAMY K,Independent,1966,2,1968,0.2,S2232
10,PANDIYAN S,Bahujan Dravida Party,1559,3,1562,0.16,S2232
11,BOOMINATHAN C,Independent,1211,2,1213,0.12,S2232
12,MUTHUPANDI S,Independent,1206,1,1207,0.12,S2232
13,RAMANATHAN S,Independent,1191,3,1194,0.12,S2232
14,VENKATESH S,Independent,1041,5,1046,0.11,S2232
15,SANKARAPANDI M.P.,Independent,1025,4,1029,0.1,S2232
16,GOPISON M.M.,Independent,942,4,946,0.1,S2232
17,SARAVANAN K.K.,Independent,843,1,844,0.09,S2232
18,GOPALAKRISHNAN S,Independent,745,1,746,0.08,S2232
19,CHANDRASEKAR N,Independent,708,3,711,0.07,S2232
20,PANDIYAN P,Socialist Unity Centre Of India (COMMUNIST),576,2,578,0.06,S2232
21,AVADAINATHAN V,Independent,461,1,462,0.05,S2232
22,NOTA,None of the Above,11074,100,11174,1.13,S2232
1,VIJAYAKUMAR (Alias) VIJAY VASANTH,Indian National Congress,540267,5981,546248,53.08,S2239
2,RADHAKRISHNAN P,Bharatiya Janata Party,361623,4718,366341,35.6,S2239
3,MARIA JENNIFER CLARA MICHAEL,Naam Tamilar Katchi,51893,828,52721,5.12,S2239
4,PASILIAN NAZERATH,All India Anna Dravida Munnetra Kazhagam,40927,466,41393,4.02,S2239
5,NAGOOR MEERAN PEER MOHAMED U,Independent,4412,3,4415,0.43,S2239
6,BERRILA L,Independent,3256,6,3262,0.32,S2239
7,BALASUBRAMANIAN T,Independent,2047,25,2072,0.2,S2239
8,VIJAYAN G,Bahujan Samaj Party,1607,16,1623,0.16,S2239
9,DENNISON V,Independent,1274,4,1278,0.12,S2239
10,DR TOM MANOHAR C M,Punnagai Desam Party,1034,6,1040,0.1,S2239
11,SATHISH BABU P,Independent,747,1,748,0.07,S2239
12,RAJAN SINGH,Bahujan Dravida Party,592,6,598,0.06,S2239
13,GEETA M,Thakkam Katchi,528,24,552,0.05,S2239
14,SANTHAKUMAR N,Independent,521,6,527,0.05,S2239
15,RAMESHKUMAR J L,Independent,464,1,465,0.05,S2239
16,ESAKKIMUTHU N,Independent,435,6,441,0.04,S2239
17,AYYAPPAN V,Independent,358,15,373,0.04,S2239
18,SARAVANAN N,Samaniya Makkal Nala Katchi,308,7,315,0.03,S2239
19,VINO JEBA SEELAN T,Independent,265,5,270,0.03,S2239
20,KRISHNAN P,Independent,250,4,254,0.02,S2239
21,VENKADESH S C,Independent,187,1,188,0.02,S2239
22,ANTONY MICHAEL J,Independent,166,9,175,0.02,S2239
23,NOTA,None of the Above,3680,76,3756,0.36,S2239
1,INDRA HANG SUBBA,Sikkim Krantikari Morcha,156836,7560,164396,42.71,S211
2,BHARAT BASNETT,Citizen Action Party-Sikkim,78666,4900,83566,21.71,S211
3,PREM DAS RAI,Sikkim Democratic Front,75464,1707,77171,20.05,S211
4,LATEN TSHERING SHERPA,Independent,20197,1066,21263,5.52,S211
5,DINESH CHANDRA NEPAL,Bharatiya Janata Party,18788,247,19035,4.95,S211
6,SAMBHU CHETTRI,Independent,4682,8,4690,1.22,S211
7,KHARGA BHADUR RAI,Sikkim Republican Party,4591,208,4799,1.25,S211
8,GOPAL CHETTRI,Indian National Congress,2190,51,2241,0.58,S211
9,NAWIN KIRAN PRADHAN,Independent,1121,45,1166,0.3,S211
10,RAVI CHANDRA RAI,Independent,1077,46,1123,0.29,S211
11,BEENA RAI,Independent,1066,59,1125,0.29,S211
12,SHYAMAL PAL,Independent,735,5,740,0.19,S211
13,RUDRA MANI PRADHAN,Independent,512,7,519,0.13,S211
14,MADHUKAR DHAKAL,Independent,511,21,532,0.14,S211
15,NOTA,None of the Above,2433,94,2527,0.66,S211
1,AMIT SHAH,Bharatiya Janata Party,999984,10988,1010972,76.48,S066
2,SONAL RAMANBHAI PATEL,Indian National Congress,261411,4845,266256,20.14,S066
3,MOHAMMEDANISH DESAI,Bahujan Samaj Party,7272,122,7394,0.56,S066
4,SHAHNAWAZKHAN SULTANKHAN PATHAN,Independent,2325,7,2332,0.18,S066
5,MALEK MAKBUL SHAKIB,Independent,2052,6,2058,0.16,S066
6,THAKOR JITENDRASINH JASHAVANTSINH,Insaniyat Party,1949,60,2009,0.15,S066
7,PARIKH RAJIVBHAI KALABHAI,Independent,1719,32,1751,0.13,S066
8,MANSURI SUHANA,Independent,1437,16,1453,0.11,S066
9,MAURYA SUMITRA DEVNARIAN,Prajatantra Aadhar Party,1205,12,1217,0.09,S066
10,UMADIYA ALIBHAI RAJABHAI,Independent,1004,5,1009,0.08,S066
11,RAHUL CHIMANBHAI MEHTA,Right to Recall Party,982,19,1001,0.08,S066
12,PATHAN IMTIYAJKHAN,Independent,786,56,842,0.06,S066
13,BAGVAN BAHADURSHAH GULMOHAMMAD,Independent,755,16,771,0.06,S066
14,NAVSADALAM IBRAHIMBHAI MALEK,Independent,726,6,732,0.06,S066
15,NOTA,None of the Above,21233,772,22005,1.66,S066
1,P. P. CHAUDHARY,Bharatiya Janata Party,750568,6821,757389,55.94,S2015
2,SANGEETA BENIWAL,Indian National Congress,505754,6284,512038,37.82,S2015
3,LAL SINGH DEWASI,Independent,18848,154,19002,1.4,S2015
4,HUKAM SINGH,Independent,16835,262,17097,1.26,S2015
5,MAHENDRA REGAR,Bahujan Samaj Party,11054,47,11101,0.82,S2015
6,JEEVARAM RANA,Bharat Adivasi Party,8325,22,8347,0.62,S2015
7,SHRAWAN RAM DEWASI,Independent,5585,8,5593,0.41,S2015
8,MUKESH SAINI,Independent,2471,52,2523,0.19,S2015
9,BASTIRAM,Indian Peoples Green Party,1570,16,1586,0.12,S2015
10,BHIYARAM,Independent,1335,10,1345,0.1,S2015
11,ANAND KUMAR PARIHAR,Independent,1327,8,1335,0.1,S2015
12,KESARAM,Independent,1327,18,1345,0.1,S2015
13,DEEPAK BAMNIYA,Independent,1256,32,1288,0.1,S2015
14,NOTA,None of the Above,13763,90,13853,1.02,S2015
1,ANUP SANJAY DHOTRE,Bharatiya Janata Party,454972,2058,457030,38.96,S136
2,ABHAY KASHINATH PATIL,Indian National Congress,414557,1847,416404,35.5,S136
3,AMBEDKAR PRAKASH YASHWANT,Vanchit Bahujan  Aaghadi,275490,1257,276747,23.59,S136
4,ADV NAJIB SHAIKH,Indian National League,3288,12,3300,0.28,S136
5,KASHINATH VISHWANATH DHAMODE,Bahujan Samaj Party,2737,23,2760,0.24,S136
6,MURLIDHAR LALSING PAWAR,Independent,2058,8,2066,0.18,S136
7,ADHAU RAVIKANT RAMKRUSHNA,Jay Vidarbha Party,1710,24,1734,0.15,S136
8,AACHARYADIP SUBHASHCHANDRA GANOJE,Independent,1610,8,1618,0.14,S136
9,UJWALA VINAYAK RAUT,Independent,1298,8,1306,0.11,S136
10,DHARMENDRA CHANDRAPRAKASH KOTHARI,Independent,1236,4,1240,0.11,S136
11,DILIP SHATRUGHAN MHAISANE,Independent,860,2,862,0.07,S136
12,ASHOK KISANRAO THORAT,Independent,573,8,581,0.05,S136
13,MOHMMAD AJAZ MOHMMAD TAHER,Azad Adhikar Sena,564,4,568,0.05,S136
14,BABAN MAHADEV SAYAM,Janseva Gondwana Party,535,2,537,0.05,S136
15,PRITI PRAMOD SADANSHIV,Republican Party of India (Social),528,8,536,0.05,S136
16,NOTA,None of the Above,5752,31,5783,0.49,S136
1,RAHUL SINGH LODHI,Bharatiya Janata Party,708589,1179,709768,65.18,S127
2,TARBAR SINGH LODHI (BANTU BHAIYA),Indian National Congress,302828,514,303342,27.86,S127
3,ENGINEER GOVERDHAN RAJ,Bahujan Samaj Party,21379,25,21404,1.97,S127
4,BHAIYA VIJAY PATEL (KURMI) TIRGARH BALE,Bhartiya Shakti Chetna Party,12200,17,12217,1.12,S127
5,MANU SINGH MARAVI,Bharat Adivasi Party,7871,16,7887,0.72,S127
6,RAHUL BHAIYA S/O RAM PRATAP,Independent,6273,12,6285,0.58,S127
7,RAHUL BHAIYA S/O JEEVAN LAL,Independent,5556,5,5561,0.51,S127
8,VEDRAM KURMI,Independent,4054,3,4057,0.37,S127
9,RAJESH SINGH SOYAM,Gondvana Gantantra Party,3172,18,3190,0.29,S127
10,RAKESH KUMAR AHIRWAR,Independent,2044,7,2051,0.19,S127
11,NANDAN KUMAR AHIRWAL,Independent,1848,5,1853,0.17,S127
12,NEELESH SONI,Independent,1277,1,1278,0.12,S127
13,DURGA MOUSI,Independent,1120,4,1124,0.1,S127
14,TARVAR SINGH LODHI,Independent,1092,2,1094,0.1,S127
15,NOTA,None of the Above,7820,13,7833,0.72,S127
1,RAJMOHAN UNNITHAN,Indian National Congress,487637,3022,490659,44.1,S111
2,M.V BALAKRISHNAN MASTER,Communist Party of India  (Marxist),385969,4041,390010,35.06,S111
3,M.L ASHWINI,Bharatiya Janata Party,217996,1562,219558,19.73,S111
4,SUKUMARI M,Bahujan Samaj Party,1599,13,1612,0.14,S111
5,RAJESWARI K.R,Independent,886,11,897,0.08,S111
6,MANOHARAN K,Independent,777,27,804,0.07,S111
7,ANEESH PAYYANNUR,Independent,744,15,759,0.07,S111
8,BALAKRISHNAN N,Independent,594,34,628,0.06,S111
9,N KESHAVA NAYAK,Independent,480,27,507,0.05,S111
10,NOTA,None of the Above,7037,75,7112,0.64,S111
1,KIRTIVARDHAN SINGH,Bharatiya Janata Party,473691,567,474258,49.77,S2459
2,SHREYA VERMA,Samajwadi Party,427363,671,428034,44.92,S2459
3,SAURABH,Bahujan Samaj Party,29388,41,29429,3.09,S2459
4,RAM UJAGAR,Independent,3535,0,3535,0.37,S2459
5,ARUNIMA PANDEY,Independent,3070,3,3073,0.32,S2459
6,RAGHAVENDRA,Bhartiya Shakti Chetna Party,2027,1,2028,0.21,S2459
7,RAJKUMAR,Independent,1988,1,1989,0.21,S2459
8,VINOD KUMAR SINGH,Bhartiya Uday Nirman Party,1482,1,1483,0.16,S2459
9,NOTA,None of the Above,9048,7,9055,0.95,S2459
1,RAJ KUMAR ROAT,Bharat Adivasi Party,815430,5401,820831,50.15,S2020
2,MAHENDRAJEETSINGH MALVIYA,Bharatiya Janata Party,568589,5188,573777,35.05,S2020
3,RAJKUMAR S/O HIRALAL,Independent,74551,47,74598,4.56,S2020
4,ARVIND SITA DAMOR,Indian National Congress,60917,294,61211,3.74,S2020
5,RAJKUMAR S/O PREMJI,Independent,41742,48,41790,2.55,S2020
6,BANSHILAL AHARI,Independent,17884,12,17896,1.09,S2020
7,SHANKARLAL BAMANIYA,Indian Peoples Green Party,17169,19,17188,1.05,S2020
8,DILEEP KUMAR MEENA,Bahujan Samaj Party,8573,18,8591,0.52,S2020
9,NOTA,None of the Above,20892,78,20970,1.28,S2020
1,MOHAMMAD JAWED,Indian National Congress,402470,380,402850,35,S0410
2,MUJAHID ALAM,Janata Dal  (United),342795,363,343158,29.81,S0410
3,AKHTARUL IMAN,All India Majlis-E-Ittehadul Muslimeen,309011,253,309264,26.87,S0410
4,BIDESHI RISHIDEV,Independent,11815,3,11818,1.03,S0410
5,VISHWANATH TUDU,Independent,11300,2,11302,0.98,S0410
6,MD GUFRAN JAMALI,Independent,9992,1,9993,0.87,S0410
7,HASIRUL,Independent,9522,2,9524,0.83,S0410
8,BABUL ALAM,Bahujan Samaj Party,7575,4,7579,0.66,S0410
9,RAVI KUMAR ROY,Independent,7299,3,7302,0.63,S0410
10,SHAHABUZZAMA BHARTIYA,Rashtriya Samaj Paksha,6055,0,6055,0.53,S0410
11,CHHOTE LAL MAHTO,Independent,3758,5,3763,0.33,S0410
12,MOHAMMAD KAUSAR PERWEZ,Independent,3525,0,3525,0.31,S0410
13,NOTA,None of the Above,24953,13,24966,2.17,S0410
1,SURENDRA PRASAD YADAV,Rashtriya Janata Dal,440352,2683,443035,47.88,S0436
2,CHANDESHWAR PRASAD,Janata Dal  (United),299044,1400,300444,32.47,S0436
3,ARUN KUMAR,Bahujan Samaj Party,85696,684,86380,9.33,S0436
4,MINTA DEVI,Independent,16112,11,16123,1.74,S0436
5,MUNILAL YADAV,Independent,13021,8,13029,1.41,S0436
6,ASHUTOSH KUMAR,Rashtriya Jan Jan Party,12954,259,13213,1.43,S0436
7,DEEPAK KUMAR,Jagrook Janta Party,8944,26,8970,0.97,S0436
8,BUDDHADEV SAV,Independent,5765,8,5773,0.62,S0436
9,NARESH KUMAR,Independent,5709,3,5712,0.62,S0436
10,CHANDESHWAR PRASAD,Independent,5356,22,5378,0.58,S0436
11,PIYUSH SINGH,Shoshit Samaj Dal,4611,7,4618,0.5,S0436
12,RAJ KISHOR SHARMA,Bhartiya Sarthak Party,3230,13,3243,0.35,S0436
13,KAPIL CHAUHAN,Jan Janwadi Party,2954,10,2964,0.32,S0436
14,ASHUTOSH VINAY KUMAR,Rashtriya Garib Dal,2895,14,2909,0.31,S0436
15,UMA SHANKAR VERMA,Socialist Unity Centre Of India (COMMUNIST),2509,15,2524,0.27,S0436
16,NOTA,None of the Above,10960,95,11055,1.19,S0436
1,V K SREEKANDAN,Indian National Congress,418072,3097,421169,40.66,S118
2,A VIJAYARAGHAVAN,Communist Party of India  (Marxist),342798,3088,345886,33.39,S118
3,C KRISHNAKUMAR,Bharatiya Janata Party,249568,2210,251778,24.31,S118
4,K T PADMINI,Bahujan Samaj Party,2102,30,2132,0.21,S118
5,ANNA KURIAKOSE,Independent,1416,17,1433,0.14,S118
6,N S K PURAM SASIKUMAR,Independent,1151,26,1177,0.11,S118
7,RAJESH K SON OF VELANKUTTY,Independent,1033,23,1056,0.1,S118
8,RAJESH M SON OF MANI C,Independent,947,6,953,0.09,S118
9,SIDHEEK IRUPPASSERY,Independent,913,26,939,0.09,S118
10,C RAJAMANICKAM,Independent,516,4,520,0.05,S118
11,NOTA,None of the Above,8724,69,8793,0.85,S118
1,EATALA RAJENDER,Bharatiya Janata Party,980712,10330,991042,51.25,S297
2,PATNAM SUNEETHA MAHENDER REDDY,Indian National Congress,593337,6230,599567,31,S297
3,RAGIDI LAXMA REDDY,Bharat Rashtra Samithi,298697,1789,300486,15.54,S297
4,THALLADA VENKATESWARLU,Independent,6784,16,6800,0.35,S297
5,ANITHA REDDY SHEELAM,Bahujan Samaj Party,4718,61,4779,0.25,S297
6,VAISHNAVI PRASAD,Independent,1894,18,1912,0.1,S297
7,PAREE (PESARIKAYALA PAREEKSHITH REDDY),Independent,1831,4,1835,0.09,S297
8,DONTHULA BIKSHAPATHI,Independent,1813,8,1821,0.09,S297
9,BHARATHA SUDARSHAN,Independent,1639,4,1643,0.08,S297
10,APPARAO KONDA,Rashtra Samanya Praja Party,1157,5,1162,0.06,S297
11,MOUTAM SAMPATH,Independent,1135,2,1137,0.06,S297
12,RAJESH MISHRA,Independent,1110,0,1110,0.06,S297
13,BANJAPALLY SUDHA RANI,Independent,1064,5,1069,0.06,S297
14,CHIRIPI REDDY RAMESH,Independent,986,1,987,0.05,S297
15,PEDDAPALLI SANDEEP,Bharathiya YuvaKula Dalam,930,3,933,0.05,S297
16,BOIN DURGA PRASAD YADAV,Dharma Samaj Party,778,11,789,0.04,S297
17,CHAMAKURA RAJAIAH ALIAS PIDIKILI RAJU,Social Justice Party of India,722,1,723,0.04,S297
18,NARRA SUKHENDER REDDY,Vidhyarthula Rajakiya Party,690,4,694,0.04,S297
19,KANTE SAYANNA,Independent,539,0,539,0.03,S297
20,JUVVA PHANI KUMAR CHOWDARY,Jai Bharat National Party,505,3,508,0.03,S297
21,YADISHWAR NAKKA,Telangana Republican Party,492,2,494,0.03,S297
22,R. SUBENDER SINGH,Independent,446,1,447,0.02,S297
23,NOTA,None of the Above,13206,160,13366,0.69,S297
1,BALABHADRA MAJHI,Bharatiya Janata Party,478330,3066,481396,38.74,S1812
2,PRADEEP KUMAR MAJHI,Biju Janata Dal,392448,1412,393860,31.7,S1812
3,BHUJABAL MAJHI,Indian National Congress,302095,1297,303392,24.42,S1812
4,TRINATH MUNDAGUDIA,Socialist Unity Centre Of India (COMMUNIST),20548,11,20559,1.65,S1812
5,NOTA,None of the Above,43240,28,43268,3.48,S1812
1,SHER SINGH GHUBAYA,Indian National Congress,264712,1914,266626,23.7,S1910
2,JAGDEEP SINGH KAKA BRAR,Aam Aadmi Party,261273,2111,263384,23.41,S1910
3,GURMIT SINGH SODHI,Bharatiya Janata Party,253841,1256,255097,22.67,S1910
4,NARDEV SINGH BOBBY MANN,Shiromani Akali Dal,252327,1318,253645,22.54,S1910
5,GURCHARAN SINGH BHULLAR,Shiromani Akali Dal (Amritsar)(Simranjit Singh Mann),15836,105,15941,1.42,S1910
6,FOJI ANGREJ SINGH WARWAL,Independent,9435,43,9478,0.84,S1910
7,SURINDER KAMBOJ,Bahujan Samaj Party,8347,86,8433,0.75,S1910
8,JASKARAN SINGH KAHAN SINGH WALA,Independent,6480,55,6535,0.58,S1910
9,SUKHDEV SINGH,Independent,4597,2,4599,0.41,S1910
10,SAHIL MONGA,Independent,3705,19,3724,0.33,S1910
11,PRITAM SINGH,Independent,3030,1,3031,0.27,S1910
12,GURPREET SINGH,Independent,2894,3,2897,0.26,S1910
13,ARWINDER SINGH,Independent,2556,14,2570,0.23,S1910
14,DEEPAK KUMAR DEEP DASHANAND,Independent,2435,1,2436,0.22,S1910
15,RAJ,Independent,2428,4,2432,0.22,S1910
16,PREM CHAND BOONGI,Punjab National Party,1944,3,1947,0.17,S1910
17,AJIT SINGH,Rashtriya Republican Party,1609,6,1615,0.14,S1910
18,SURINDER KUMAR BANSAL,Independent,1537,3,1540,0.14,S1910
19,HARPREET SINGH,Independent,1531,7,1538,0.14,S1910
20,KULDEEP SINGH,India Praja Bandhu Party,1484,6,1490,0.13,S1910
21,BALWINDER SINGH CHOHAN,Jan Sewa Driver Party,1366,1,1367,0.12,S1910
22,BALWINDER SINGH,Republican Party of India (Athawale),1364,0,1364,0.12,S1910
23,GURCHARAN SINGH,Independent,1338,4,1342,0.12,S1910
24,UMESH KUMAR,Independent,1319,1,1320,0.12,S1910
25,BALWANT SINGH SAMMEWALI,Nationalist Justice Party,1148,4,1152,0.1,S1910
26,MOHAN SINGH,Independent,1075,3,1078,0.1,S1910
27,JASKARAN SINGH SIDHU,Independent,970,1,971,0.09,S1910
28,JASWANT SINGH KHATRI,Independent,820,1,821,0.07,S1910
29,CHAMKAUR SINGH,Independent,638,4,642,0.06,S1910
30,NOTA,None of the Above,5895,205,6100,0.54,S1910
1,KISHORI LAL,Indian National Congress,536680,2548,539228,54.99,S2437
2,SMRITI IRANI,Bharatiya Janata Party,370754,1278,372032,37.94,S2437
3,NANHE SINGH CHAUHAN,Bahujan Samaj Party,34418,116,34534,3.52,S2437
4,SURENDRA KUMAR,Independent,5699,0,5699,0.58,S2437
5,DINESH CHANDRA MAURYA,Janshakti Samta Party,4569,8,4577,0.47,S2437
6,JAGDAMBA PRASAD YADAV,Independent,4019,1,4020,0.41,S2437
7,BHAGWANDIN PASI,Moulik Adhikar Party,2333,1,2334,0.24,S2437
8,CHANDRAWATI,Independent,2278,13,2291,0.23,S2437
9,MOHD HASAN LAHRI,Rashtriya Narayanwadi Vikas Party,1525,2,1527,0.16,S2437
10,KHUSHIRAM,Independent,1401,0,1401,0.14,S2437
11,UDAYRAJ,Independent,1300,5,1305,0.13,S2437
12,SANTRAM,Samajhdar Party,1208,4,1212,0.12,S2437
13,SHAILENDRA KUMAR MISHRA,Sanyogwadi Party,1124,4,1128,0.12,S2437
14,NOTA,None of the Above,9371,12,9383,0.96,S2437
1,RAJESH VERMA,Lok Janshakti Party(Ram Vilas),537331,1326,538657,50.73,S0425
2,SANJAY KUMAR,Communist Party of India  (Marxist),375988,1538,377526,35.55,S0425
3,RUPAM DEVI,Independent,27370,25,27395,2.58,S0425
4,SONU KUMAR,Independent,24478,5,24483,2.31,S0425
5,PINKESH KUMAR,Rashtriya Jan Kalyan Party Secular,19487,8,19495,1.84,S0425
6,DR RAVI KUMAR,Bahujan Samaj Party,13894,159,14053,1.32,S0425
7,AJAY KUMAR,Rashtriya Jansambhavna Party,8256,54,8310,0.78,S0425
8,PRIYADARSHEE DINKAR,Independent,7892,12,7904,0.74,S0425
9,DINANATH CHANDRAVANSHI,Independent,6142,20,6162,0.58,S0425
10,CHANDRA KISHOR THAKUR,Aam Janta Party Rashtriya,2806,43,2849,0.27,S0425
11,ASIF IMAM,Aadarsh Mithila Party,2434,9,2443,0.23,S0425
12,KANCHAN MALA,Hindustan People's Party (Democratic),1478,28,1506,0.14,S0425
13,NOTA,None of the Above,31056,55,31111,2.93,S0425
1,SAYANI GHOSH,All India Trinamool Congress,714049,3850,717899,45.83,S2522
2,DR. ANIRBAN GANGULY,Bharatiya Janata Party,457307,2391,459698,29.35,S2522
3,SRIJAN BHATTACHARYYA,Communist Party of India  (Marxist),256951,1761,258712,16.52,S2522
4,NUR ALAM KHAN,All India Secular Front,83291,71,83362,5.32,S2522
5,RANJIT KUMAR MANDAL,Independent,13021,9,13030,0.83,S2522
6,HOSEN GAZI,Independent,4925,2,4927,0.31,S2522
7,SANDIP NATH,Bahujan Samaj Party,4434,28,4462,0.28,S2522
8,KALPANA NASKAR DATTA,Socialist Unity Centre Of India (COMMUNIST),4416,35,4451,0.28,S2522
9,BALARAM MANDAL,Independent,2829,6,2835,0.18,S2522
10,TANUSHREE MONDAL,Independent,2419,8,2427,0.15,S2522
11,SHANKAR MANDAL,Independent,1439,3,1442,0.09,S2522
12,SRI GOPAN SARDAR,Mulnibasi Party of India,1366,7,1373,0.09,S2522
13,PURNIMA DEBNATH,Independent,1301,24,1325,0.08,S2522
14,CHANDRACHUR GOSWAMI,Independent,1112,2,1114,0.07,S2522
15,ARUN SARKAR,Independent,1107,3,1110,0.07,S2522
16,DIPAK SARDAR,Independent,924,3,927,0.06,S2522
17,NOTA,None of the Above,7316,99,7415,0.47,S2522
1,ARVIND GANPAT SAWANT,Shiv Sena (Uddhav Balasaheb Thackrey),393735,1920,395655,51.18,S1331
2,YAMINI YASHWANT JADHAV,Shiv Sena,341291,1691,342982,44.36,S1331
3,AFZAL S. DAWOODANI,Vanchit Bahujan  Aaghadi,5575,37,5612,0.73,S1331
4,MOHAMMED SHUAIB BASHIR KHATEEB,Bahujan Samaj Party,4440,38,4478,0.58,S1331
5,ARVIND NARAYAN SAWANT,Independent,3065,25,3090,0.4,S1331
6,MOHD. NAEEM SHAIKH,Aim Political Party,1709,6,1715,0.22,S1331
7,SABEEHA KHAN,Independent,1678,16,1694,0.22,S1331
8,GOHIL MANISHA SHIVRAM,Independent,1032,13,1045,0.14,S1331
9,SHANKAR SONAWANE,Independent,854,8,862,0.11,S1331
10,RAHUL PHANASWADIKAR,Lokshahi Ekta Party,784,3,787,0.1,S1331
11,SUBHASH RAMESH CHIPLUNKAR,Rashtriya Kisan Bahujan Party,563,4,567,0.07,S1331
12,PRASHANT PRAKASH GHADGE,Independent,487,3,490,0.06,S1331
13,MOHAMMED MAHTAB SHAIKH,Independent,455,3,458,0.06,S1331
14,MATEEN AHMED RANGREJ,Independent,265,2,267,0.03,S1331
15,NOTA,None of the Above,13290,121,13411,1.73,S1331
1,E. TUKARAM,Indian National Congress,729581,1264,730845,52.58,S109
2,B. SREERAMULU,Bharatiya Janata Party,629813,2040,631853,45.46,S109
3,VALMIKI KRISHNAPPA,Bahujan Samaj Party,5901,10,5911,0.43,S109
4,C. CHANNAVEERA,Karnataka Rashtra Samithi,3794,3,3797,0.27,S109
5,CONDUCTOR PAMPAPATHI,Independent,2458,2,2460,0.18,S109
6,VEERESH,Independent,1862,8,1870,0.13,S109
7,A. DEVADAS,Socialist Unity Centre Of India (COMMUNIST),1739,2,1741,0.13,S109
8,MANJUNATHA GOSAL,Prahar Janshakti Party,1319,3,1322,0.1,S109
9,ARUN.S.HIREHAL,Independent,1281,1,1282,0.09,S109
10,G. SWAMY,Navabharath Sena,940,4,944,0.07,S109
11,NOTA,None of the Above,7871,18,7889,0.57,S109
1,ANIL BALUNI,Bharatiya Janata Party,418531,13628,432159,58.6,S282
2,GANESH GODIYAL,Indian National Congress,262692,5964,268656,36.43,S282
3,SONU KUMAR,Independent,4803,19,4822,0.65,S282
4,ASHUTOSH SINGH,Uttarakhand Kranti Dal,4182,379,4561,0.62,S282
5,DHEER SINGH,Bahujan Samaj Party,4007,115,4122,0.56,S282
6,MUKESH PRAKASH,Independent,3064,15,3079,0.42,S282
7,SURESHI DEVI,Peoples Party of India (Democratic),1472,40,1512,0.21,S282
8,DEEPENDRA SINGH NEGI,Independent,1408,232,1640,0.22,S282
9,ARJUN SINGH,Akhil Bhartiya Parivar Party,1308,70,1378,0.19,S282
10,RESHMA PANWAR,Socialist Unity Centre Of India (COMMUNIST),1168,125,1293,0.18,S282
11,DR MUKESH PANT,Sainik Samaj Party,1121,58,1179,0.16,S282
12,VINOD KUMAR SHARMA,Uttarakhand Samanta Party,838,46,884,0.12,S282
13,SHYAMLAL,Bahujan Mukti Party,743,28,771,0.1,S282
14,NOTA,None of the Above,11224,151,11375,1.54,S282
1,ARVIND DHARMAPURI,Bharatiya Janata Party,588244,4074,592318,48.02,S294
2,JEEVANREDDY THATIPARTHI,Indian National Congress,480501,2576,483077,39.16,S294
3,GOVERDHAN BAJIREDDY,Bharat Rashtra Samithi,101929,477,102406,8.3,S294
4,GANTA CHARITHA RAO,Independent,5707,3,5710,0.46,S294
5,YOUGENDAR GATLA,Alliance of Democratic Reforms Party,5439,14,5453,0.44,S294
6,KOTAGIRI SRINIVAS,Independent,5308,4,5312,0.43,S294
7,PUPPALA LIMBADRI,Bahujan Samaj Party,4220,43,4263,0.35,S294
8,TUTUKURU JEEVAN REDDY,Independent,4085,6,4091,0.33,S294
9,KANDELA SUMAN,Dharma Samaj Party,3842,44,3886,0.32,S294
10,GOLI. NARESH,Dalita Bahujana Party,3017,7,3024,0.25,S294
11,ARE RAJENDHAR,Independent,2906,1,2907,0.24,S294
12,KOTHAKONDA SHAKTI PRASAD,Independent,2103,3,2106,0.17,S294
13,VEMULAA VIKRAM REDDY,Independent,2073,1,2074,0.17,S294
14,GOPI CHENDRIAH,Independent,1721,2,1723,0.14,S294
15,ALI MANSOOR,Anna YSR Congress Party,1454,14,1468,0.12,S294
16,GUYYA SAIKRISHNA MURTHY,Yuga Thulasi Party,1123,6,1129,0.09,S294
17,SYED ASGAR,Independent,1046,2,1048,0.08,S294
18,MALAVAT VITHAL,Independent,919,0,919,0.07,S294
19,MOGILI RAJKUMAR,India Praja Bandhu Party,825,5,830,0.07,S294
20,RAPELLY SRINIVAS,Independent,791,2,793,0.06,S294
21,DESHABOINA LAXMINARAYANA,Independent,723,0,723,0.06,S294
22,ABBAGONI ASHOK GOUD,Bahujana Left Party,641,8,649,0.05,S294
23,DEVATHI SRINIVAS,Bahujan Mukti Party,624,12,636,0.05,S294
24,B B NAIK,Independent,581,0,581,0.05,S294
25,BHUKYA. NANDU,Vidhyarthula Rajakiya Party,574,6,580,0.05,S294
26,RAPALLY SATYANARAYANA,Independent,425,1,426,0.03,S294
27,RAGI ANIL,Independent,367,8,375,0.03,S294
28,PALAMURI SAI NIKHIL,Independent,303,4,307,0.02,S294
29,PRASHANTH KATRAJI,Independent,284,0,284,0.02,S294
30,NOTA,None of the Above,4440,43,4483,0.36,S294
1,JUGAL KISHORE,Bharatiya Janata Party,677571,10017,687588,52.8,U085
2,RAMAN BHALLA,Indian National Congress,546031,6059,552090,42.4,U085
3,JAGDISH RAJ,Bahujan Samaj Party,10253,47,10300,0.79,U085
4,SATISH POONCHI,Independent,5948,11,5959,0.46,U085
5,ANKUR SHARMA,Ekam Sanatan Bharat Dal,4268,10,4278,0.33,U085
6,NARESH KUMAR CHIB,Jammu & Kashmir National Panthers Party (Bhim),4231,12,4243,0.33,U085
7,PRINCIPAL C D SHARMA,Independent,3256,1,3257,0.25,U085
8,KARANJIT,Independent,3199,8,3207,0.25,U085
9,SHABER AHMED,Independent,3174,3,3177,0.24,U085
10,SHIKHA BANDRAL,National Awami United Party,2932,5,2937,0.23,U085
11,DR PRINCE RAINA,Independent,2863,3,2866,0.22,U085
12,RAJ KUMAR,Independent,2611,7,2618,0.2,U085
13,SURINDER SINGH,Independent,2216,10,2226,0.17,U085
14,ATUL RAINA,Independent,2063,5,2068,0.16,U085
15,RATTAN LAL,Jammu & Kashmir People Conference,1650,1,1651,0.13,U085
16,SWAMI DIVYA NAND,Jammu and Kashmir Nationalist People's Front,1618,2,1620,0.12,U085
17,PERSEEN SINGH,Independent,1587,2,1589,0.12,U085
18,NARESH KUMAR TALLA,Independent,1458,1,1459,0.11,U085
19,GANESH CHOUDHARY,Hindustan Shakti Sena,1187,3,1190,0.09,U085
20,VICKY KUMAR DOGRA,Independent,1163,2,1165,0.09,U085
21,BANSI LAL,Independent,1051,8,1059,0.08,U085
22,QARI ZAHEER ABBAS BHATTI,All India Forward Bloc,983,1,984,0.08,U085
23,NOTA,None of the Above,4631,14,4645,0.36,U085
1,VISHNU DAYAL RAM,Bharatiya Janata Party,762290,8072,770362,55.39,S2713
2,MAMTA BHUIYAN,Rashtriya Janata Dal,473668,7887,481555,34.63,S2713
3,KAMESHWAR BAITHA,Bahujan Samaj Party,39267,733,40000,2.88,S2713
4,SANAN RAM,Lokhit Adhikar Party,17849,26,17875,1.29,S2713
5,GANESH RAVI,Independent,17669,30,17699,1.27,S2713
6,BRAJESH KUMAR TURI,Rashtriya Samanta Dal,17542,24,17566,1.26,S2713
7,VRINDA RAM,Peoples Party of India (Democratic),11205,65,11270,0.81,S2713
8,MAHENDRA BAITHA,Socialist Unity Centre Of India (COMMUNIST),5097,18,5115,0.37,S2713
9,RAM VACHAN RAM,Bahujan Mukti Party,4924,29,4953,0.36,S2713
10,NOTA,None of the Above,24226,117,24343,1.75,S2713
1,ABU TAHER KHAN,All India Trinamool Congress,681674,768,682442,44.27,S2511
2,MD SALIM,Communist Party of India  (Marxist),517733,494,518227,33.62,S2511
3,GOURI SANKAR GHOSH,Bharatiya Janata Party,291013,1018,292031,18.94,S2511
4,HABIB SAIKH,All India Secular Front,12359,11,12370,0.8,S2511
5,ASIM RAY,Bhartiya Lokmat Rashtrwadi Party,5522,12,5534,0.36,S2511
6,SAHABUDDIN MALLIK,Independent,4156,0,4156,0.27,S2511
7,RAFIKUL ISLAM,Independent,4064,1,4065,0.26,S2511
8,MAHAFUJUL ALAM,Socialist Unity Centre Of India (COMMUNIST),3423,3,3426,0.22,S2511
9,MD TAIEDUL ISLAM,Social Democratic Party Of India,3291,2,3293,0.21,S2511
10,DHANANJOY SARKAR,Independent,1535,4,1539,0.1,S2511
11,KRISHNA PROSAD BISWAS,Independent,1197,9,1206,0.08,S2511
12,NOTA,None of the Above,13249,21,13270,0.86,S2511
1,SUKHDEO BHAGAT,Indian National Congress,476112,6926,483038,49.95,S2712
2,SAMIR ORAON,Bharatiya Janata Party,339685,4215,343900,35.56,S2712
3,CHAMRA LINDA,Independent,45082,916,45998,4.76,S2712
4,MAHENDRA ORAON,Communist Party of India,16776,17,16793,1.74,S2712
5,SHANIYA ORAON,Independent,10894,17,10911,1.13,S2712
6,GIRJANANDAN URAON,Bahujan Samaj Party,9103,45,9148,0.95,S2712
7,MARIANUS TIGGA,Independent,9100,31,9131,0.94,S2712
8,STEPHAN KINDO,Independent,7594,5,7599,0.79,S2712
9,BIHARI BHAGAT,Peoples Party of India (Democratic),7558,44,7602,0.79,S2712
10,RANJEET BHAGAT,Independent,5510,17,5527,0.57,S2712
11,RAMCHANDRA BHAGAT,Lokhit Adhikar Party,4303,7,4310,0.45,S2712
12,PAWAN TIGGA,Independent,3685,28,3713,0.38,S2712
13,ARPAN DEO BHAGAT,Independent,2796,18,2814,0.29,S2712
14,ARJUN TOPPO,Independent,2706,41,2747,0.28,S2712
15,MANI MUNDA,Bhagidari Party(P),2490,20,2510,0.26,S2712
16,NOTA,None of the Above,11304,80,11384,1.18,S2712
1,DEVESH CHANDRA THAKUR,Janata Dal  (United),514940,779,515719,47.14,S045
2,ARJUN RAY,Rashtriya Janata Dal,463107,1256,464363,42.45,S045
3,SAIQUA NAWAZ AZMAT,Independent,28911,1,28912,2.64,S045
4,SHYAM NANDAN KISHOR PRASAD,Independent,11173,15,11188,1.02,S045
5,BHOLA SINGH,Bahujan Samaj Party,8773,37,8810,0.81,S045
6,UPENDRA SAHANI,Rashtriya Jansambhavna Party,8446,8,8454,0.77,S045
7,CHANDRIKA PRASAD,Independent,7109,5,7114,0.65,S045
8,VINOD SAH,Independent,4477,4,4481,0.41,S045
9,KRISHNA KISHORE,Independent,3280,0,3280,0.3,S045
10,MUSHAHID RAZA,Desh Janhit Party,2190,2,2192,0.2,S045
11,UMESH KUMAR YADAV,Independent,2126,2,2128,0.19,S045
12,RAJENDRA MAHTO,Karpoori Janta Dal,1976,5,1981,0.18,S045
13,ANAND KUMAR,Independent,1787,9,1796,0.16,S045
14,ABDUL SAMAD,Independent,1439,2,1441,0.13,S045
15,NOTA,None of the Above,32102,31,32133,2.94,S045
1,SARABJEET SINGH KHALSA,Independent,296922,1140,298062,29.38,S199
2,KARAMJIT SINGH ANMOL,Aam Aadmi Party,226676,1333,228009,22.48,S199
3,AMARJIT KAUR SAHOKE,Indian National Congress,159352,1005,160357,15.81,S199
4,RAJWINDER SINGH DHARAMKOT,Shiromani Akali Dal,137776,475,138251,13.63,S199
5,HANS RAJ HANS,Bharatiya Janata Party,123007,526,123533,12.18,S199
6,GURCHARAN SINGH MANN,Communist Party of India,14935,15,14950,1.47,S199
7,GURBAKSH SINGH CHAUHAN,Bahujan Samaj Party,8129,81,8210,0.81,S199
8,AVTAR SINGH SAHOTA,Independent,4155,5,4160,0.41,S199
9,KIKKAR SINGH DHALIWAL,Independent,3514,3,3517,0.35,S199
10,KARAM SINGH MALUKA,Independent,2859,3,2862,0.28,S199
11,RUPINDER SINGH KOHARWALA,Nationalist Justice Party,2672,5,2677,0.26,S199
12,BALDEV SINGH GAGRA,Shiromani Akali Dal (Amritsar)(Simranjit Singh Mann),2367,28,2395,0.24,S199
13,NIRMAL SINGH RAJEANA,Independent,2287,2,2289,0.23,S199
14,BADAL SINGH BHALOOR,Bhartiya Rashtriya Dal,2027,1,2028,0.2,S199
15,RAJ KUMAR CHAUHAN,Independent,1958,3,1961,0.19,S199
16,OM PARKASH BANKA,Independent,1947,3,1950,0.19,S199
17,CAPTAIN BAHADUR SINGH,Independent,1632,8,1640,0.16,S199
18,MEJOR SINGH BHATTI,Jan Sewa Driver Party,1605,7,1612,0.16,S199
19,SUKHBIR SINGH BABBAL BHATTI,Rashtriya Republican Party,1526,4,1530,0.15,S199
20,GURMEET SINGH,Independent,1419,1,1420,0.14,S199
21,AMRIK SINGH,Independent,1411,3,1414,0.14,S199
22,MANPREET SHANT,Independent,1376,1,1377,0.14,S199
23,PREM LAL,Democratic Bharatiya Samaj Party,1165,0,1165,0.11,S199
24,PARGAT SINGH RAJEANA,Apna Samaj Party,1128,3,1131,0.11,S199
25,JASWANT RAI RAJORA,Independent,1042,5,1047,0.1,S199
26,DR DEV INDER GAGALANI,Republican Party of India,1035,5,1040,0.1,S199
27,PRITAM SINGH,Bahujan Mukti Party,927,12,939,0.09,S199
28,KULWANT KAUR,Sanjhi Virasat Party,785,1,786,0.08,S199
29,NOTA,None of the Above,4077,66,4143,0.41,S199
1,CHUDASAMA RAJESHBHAI NARANBHAI,Bharatiya Janata Party,578516,5533,584049,54.67,S0613
2,JOTVA HIRABHAI ARJANBHAI,Indian National Congress,444156,4399,448555,41.99,S0613
3,MAKADIA JAYANTILAL MALDEBHAI,Bahujan Samaj Party,7132,150,7282,0.68,S0613
4,VADHER DANSING CHINABHAI,Independent,5161,28,5189,0.49,S0613
5,DEVENDRABHAI DHANJIBHAI MOTIVARAS,Independent,2302,7,2309,0.22,S0613
6,BORICHANGAR BHAVESH DALPATRAI,Independent,1884,24,1908,0.18,S0613
7,DAKI NATHABHAI MENSIBHAI,Independent,1329,15,1344,0.13,S0613
8,ISHWAR RAMBHAI SOLANKI,Right to Recall Party,1150,21,1171,0.11,S0613
9,ALPESHKUMAR CHANDULAL TRAMBADIYA,Log Party,943,21,964,0.09,S0613
10,GORDHANBHAI MANGABHAI GOHEL,Independent,758,17,775,0.07,S0613
11,AARAB HASAM SUMRA,Independent,689,5,694,0.06,S0613
12,NOTA,None of the Above,13434,579,14013,1.31,S0613
1,CHANDRASHEKHAR,Aazad Samaj Party (Kanshi Ram),511812,740,512552,51.19,S245
2,OM KUMAR,Bharatiya Janata Party,359751,1328,361079,36.06,S245
3,MANOJ KUMAR,Samajwadi Party,102104,270,102374,10.22,S245
4,SURENDRA PAL SINGH,Bahujan Samaj Party,13212,60,13272,1.33,S245
5,JOGENDRA,Independent,4509,9,4518,0.45,S245
6,SANJEEV KUMAR,Independent,2195,6,2201,0.22,S245
7,NOTA,None of the Above,5287,20,5307,0.53,S245
1,DR. PRADEEP KUMAR PANIGRAHY,Bharatiya Janata Party,510585,2517,513102,49.2,S1820
2,BHRUGU BAXIPATRA,Biju Janata Dal,346780,846,347626,33.33,S1820
3,RASMI RANJAN PATNAIK,Indian National Congress,129096,648,129744,12.44,S1820
4,V CHANDRA SHEKHAR,Independent,8376,3,8379,0.8,S1820
5,BHASKAR CHAUDHORY,Bahujan Samaj Party,5198,13,5211,0.5,S1820
6,SOMANATH BEHERA,Socialist Unity Centre Of India (COMMUNIST),5121,14,5135,0.49,S1820
7,SIRIN TAMMANA,Independent,5069,9,5078,0.49,S1820
8,BOMMALI KANTA RAO,Naba Bharata Nirmana Seva Party,4190,11,4201,0.4,S1820
9,RAM SANKAR SATAPATHY,Independent,3869,2,3871,0.37,S1820
10,RAJENDRA DALABEHERA,Bharatiya Bikash Parishad,2335,8,2343,0.22,S1820
11,SANTOSH KUMAR SAHU,All India Forward Bloc,2284,7,2291,0.22,S1820
12,NOTA,None of the Above,15903,39,15942,1.53,S1820
1,CHIRAG PASWAN,Lok Janshakti Party(Ram Vilas),613106,2612,615718,53.29,S0421
2,SHIV CHANDRA RAM,Rashtriya Janata Dal,442553,3060,445613,38.57,S0421
3,SURENDRA KUMAR PASWAN,Independent,17241,4,17245,1.49,S0421
4,SHASHI SWARAJ,Bahujan Samaj Party,8591,88,8679,0.75,S0421
5,HARIWANSH PASWAN,Independent,7113,4,7117,0.62,S0421
6,SHAILENDRA KUMAR,Independent,6153,8,6161,0.53,S0421
7,ASHOK KUMAR,Samata Party,4701,20,4721,0.41,S0421
8,RANDHIR PASWAN,Independent,2671,4,2675,0.23,S0421
9,RAJ KUMAR PASWAN,Yuva Bihar Sena,1983,7,1990,0.17,S0421
10,DHARMENDRA KUMAR,Jantantra Awaj Party,1971,7,1978,0.17,S0421
11,MADHUSUDHAN PASWAN,Independent,1793,8,1801,0.16,S0421
12,RAJESH KUMAR RAUSHAN,Socialist Unity Centre Of India (COMMUNIST),1694,7,1701,0.15,S0421
13,MEGHNATH PASWAN,Independent,1680,0,1680,0.15,S0421
14,BALENDRA DAS,Janshakti Janta Dal,1308,10,1318,0.11,S0421
15,NOTA,None of the Above,36836,91,36927,3.2,S0421
1,N K PREMACHANDRAN,Revolutionary Socialist Party,437516,6112,443628,48.45,S1118
2,M MUKESH,Communist Party of India  (Marxist),288861,4465,293326,32.03,S1118
3,KRISHNAKUMAR G,Bharatiya Janata Party,160956,2254,163210,17.82,S1118
4,VIPINLAL VIDHYADHARAN,Bahujan Samaj Party,2163,31,2194,0.24,S1118
5,PREMACHANDRAN NAIR,Independent,1713,21,1734,0.19,S1118
6,GOKULAM SURESH KUMAR,Independent,1369,5,1374,0.15,S1118
7,PRADEEP KOTTARAKKARA,Bharatheeya Jawan Kisan Party,793,42,835,0.09,S1118
8,TWINKLE PRABHAKARAN,Socialist Unity Centre Of India (COMMUNIST),689,19,708,0.08,S1118
9,JOSE SARANATH,Ambedkarite Party of India,553,6,559,0.06,S1118
10,BRO NOUSHAD  SHERIFF J,Independent,545,34,579,0.06,S1118
11,P KRISHNAMMAL,Marxist Communist Party of India (United),537,12,549,0.06,S1118
12,N JAYARAJAN,Independent,407,42,449,0.05,S1118
13,NOTA,None of the Above,6437,109,6546,0.71,S1118
1,KESINENI SIVANATH (CHINNI),Telugu Desam,784722,9432,794154,58.21,S0112
2,KESINENI SRINIVAS  (NANI),Yuvajana Sramika Rythu Congress Party,505637,6432,512069,37.53,S0112
3,BHARGAV VALLURU,Indian National Congress,23498,608,24106,1.77,S0112
4,KRISHNA KISHORE YANAMANDRA,Navataram Party,7710,168,7878,0.58,S0112
5,VENKATA ASHOK PAPPURI,Independent,6672,0,6672,0.49,S0112
6,DEVARAPALLI MALLIKARJUNA RAO (MAHESH),Independent,3199,0,3199,0.23,S0112
7,MEKA VENKATESWARA RAO,Bahujan Samaj Party,2184,49,2233,0.16,S0112
8,ANIL KUMAR MADDINENI,Independent,1240,0,1240,0.09,S0112
9,BARRE SREENIVASARAO (JAI BHEEM SRINIVAS),Telugu Rajadhikara Samiti Party,609,6,615,0.05,S0112
10,SYED KHAMURUNNISA,Navarang Congress Party,600,1,601,0.04,S0112
11,CHAGANTIPATI GANGADHAR GANDHI,Pyramid Party of India,486,3,489,0.04,S0112
12,DATLA LURTHU MERI,Jaibhim Rao Bharat Party,409,8,417,0.03,S0112
13,PERAM SIVA NAGESWARA RAO,Republican Party of India (Athawale),365,3,368,0.03,S0112
14,DEVARASETTY RAVEENDRA BABU,Andhra Rastra Praja Samithi,328,3,331,0.02,S0112
15,GUJJULA LALITHA,Socialist Unity Centre Of India (COMMUNIST),323,4,327,0.02,S0112
16,N DASARADHA RAMI REDDY,All India Jaihind Party,268,1,269,0.02,S0112
17,CHINTHALACHERUVU HEMALATHA,Jai Maha Bharath Party,239,5,244,0.02,S0112
18,NOTA,None of the Above,9038,155,9193,0.67,S0112
1,SATISH KUMAR GAUTAM,Bharatiya Janata Party,500453,1381,501834,44.28,S2415
2,BIJENDRA SINGH,Samajwadi Party,485588,599,486187,42.9,S2415
3,HITENDRA KUMAR ALIAS BUNTY UPADHYAY,Bahujan Samaj Party,123770,159,123929,10.93,S2415
4,GYANI RAM,Independent,3795,4,3799,0.34,S2415
5,SATISH KUMAR,Independent,3553,8,3561,0.31,S2415
6,SATISH KUMAR,Swatantra Jantaraj Party,1647,1,1648,0.15,S2415
7,MANOJ KUMAR ALIAS MANOJ LODHI,Saman Adhikar Party,1434,6,1440,0.13,S2415
8,KESHAV DEV ALIAS PANDIT KESHAV DEV GAUTAM,Independent,1308,11,1319,0.12,S2415
9,SURENDRA,Moulik Adhikar Party,1175,3,1178,0.1,S2415
10,RAJESH KUMAR,Independent,1053,3,1056,0.09,S2415
11,DILEEP SHARMA AD.,Independent,952,3,955,0.08,S2415
12,MAHESH CHANDRA SHARMA,Independent,733,3,736,0.06,S2415
13,RAJ KUMAR,Rashtriya Shoshit Samaj Party,407,5,412,0.04,S2415
14,MANOJ KUMAR SHARMA ADVOCATE,Loktantrik Janshakti Party,371,7,378,0.03,S2415
15,NOTA,None of the Above,4916,18,4934,0.44,S2415
1,MANOHAR LAL,Bharatiya Janata Party,737282,2003,739285,54.93,S075
2,DIVYANSHU BUDHIRAJA,Indian National Congress,504437,2271,506708,37.65,S075
3,INDER SINGH,Bahujan Samaj Party,32410,98,32508,2.42,S075
4,MARATHA VIRENDER VERMA,Nationalist Congress Party – Sharadchandra Pawar,28984,167,29151,2.17,S075
5,DEVENDER KADIAN,Jannayak Janta Party,11399,68,11467,0.85,S075
6,MANOJ BANSAL,Independent,4000,4,4004,0.3,S075
7,GULSHAN KASHYAP,Independent,2987,7,2994,0.22,S075
8,ASHOK KATARIA,Samst Samaj Party,2898,6,2904,0.22,S075
9,HARJEET SINGH VIRK,Shiromani Akali Dal (Amritsar)(Simranjit Singh Mann),1857,9,1866,0.14,S075
10,SONIA,Independent,1846,5,1851,0.14,S075
11,MANISH,Independent,1587,0,1587,0.12,S075
12,LEENA KOHLI,Independent,1281,11,1292,0.1,S075
13,NITIN GEHLOT,Peoples Party of India (Democratic),1252,1,1253,0.09,S075
14,BALWAN SINGH,Independent,1186,2,1188,0.09,S075
15,VINEET CHOUDHARY,Bharatiya Asha Party,1018,2,1020,0.08,S075
16,ROOP SINGH,Rashtriya Garib Dal,766,3,769,0.06,S075
17,SAWAMI AGNIVESH,Independent,748,4,752,0.06,S075
18,AZAD SINGH PUNIA,Independent,703,2,705,0.05,S075
19,ASHOK KUMAR,Independent,631,2,633,0.05,S075
20,NOTA,None of the Above,3925,30,3955,0.29,S075
1,FAGGAN SINGH KULASTE,Bharatiya Janata Party,749761,1614,751375,48.93,S1214
2,OMKAR SINGH MARKAM,Indian National Congress,645759,1770,647529,42.17,S1214
3,MAHESH KUMAR WATTEE,Gondvana Gantantra Party,37686,111,37797,2.46,S1214
4,INDAR SINGH UIKEY,Bahujan Samaj Party,16587,30,16617,1.08,S1214
5,CHANDRA SINGH KUSHRAM,Bhartiya Shakti Chetna Party,15533,25,15558,1.01,S1214
6,SITAR MARKAM,Independent,10365,10,10375,0.68,S1214
7,RAKESH SINGH THAKUR,Independent,10340,6,10346,0.67,S1214
8,DR. BHAW SINGH TEKAM,Independent,6393,8,6401,0.42,S1214
9,CHARAN SINGH DHURWEY,Bharat Adivasi Party,4269,18,4287,0.28,S1214
10,ADVOCATE-DEV SINGH KUMRE,Independent,4205,12,4217,0.27,S1214
11,GHUR SINGH SALLAM,Independent,3959,12,3971,0.26,S1214
12,KALIYA BAI KAKODIA,Independent,2990,11,3001,0.2,S1214
13,ASHOK SARAIYA,Independent,2717,10,2727,0.18,S1214
14,RAMKUMAR INWATI [ADVOCATE],Smart Indians Party,2499,11,2510,0.16,S1214
15,NOTA,None of the Above,18887,34,18921,1.23,S1214
1,MANISH TEWARI,Indian National Congress,216350,307,216657,48.22,U021
2,SANJAY TANDON,Bharatiya Janata Party,213770,383,214153,47.67,U021
3,RITU SINGH,Bahujan Samaj Party,6697,11,6708,1.49,U021
4,LAKHVIR SINGH ALIAS KOTLA,Independent,2625,1,2626,0.58,U021
5,DEEPANSHU SHARMA,Akhil Bhartiya Parivar Party,1066,2,1068,0.24,U021
6,EX-ASSISTANT COMMANDANT RANPREET SINGH,Independent,1051,3,1054,0.23,U021
7,VINOD KUMAR,Independent,683,0,683,0.15,U021
8,SUNIL THAMAN,Haryana Jansena Party,576,1,577,0.13,U021
9,BALJEET SINGH ALIAS LADDI,Independent,434,2,436,0.1,U021
10,SUNIL KUMAR,Independent,321,0,321,0.07,U021
11,PARTAP SINGH RANA,Independent,306,1,307,0.07,U021
12,MAHANT RAVI KANT MUNI,Independent,295,0,295,0.07,U021
13,VIVEK SHARMA,Independent,294,0,294,0.07,U021
14,PIAR CHAND ALIAS KOUNDAL,Independent,253,2,255,0.06,U021
15,KISHOR KUMAR ALIAS BANTI BHAIYA,Independent,239,0,239,0.05,U021
16,RAJINDER KAUR,Sainik Samaj Party,215,2,217,0.05,U021
17,RAJ PRINCE SINGH,Super Power India Party,205,0,205,0.05,U021
18,PUSHPINDER SINGH ALIAS LOVELY ATTAWA,Independent,154,0,154,0.03,U021
19,KULDIP RAI ALIAS HAPPY SOOD MORINDA,Independent,114,0,114,0.03,U021
20,NOTA,None of the Above,2900,12,2912,0.65,U021
1,ADV. DEAN KURIAKOSE,Indian National Congress,427129,5243,432372,51.43,S1113
2,ADV. JOICE GEORGE,Communist Party of India  (Marxist),295975,2670,298645,35.53,S1113
3,ADV. SANGEETHA VISWANATHAN,Bharath Dharma Jana Sena,90663,660,91323,10.86,S1113
4,ADV. RUSSEL JOY,Bahujan Samaj Party,4397,40,4437,0.53,S1113
5,JOMON JOHN,Independent,1764,55,1819,0.22,S1113
6,SAJI @ SHAJI,Viduthalai Chiruthaigal Katchi,1493,15,1508,0.18,S1113
7,P.K. SAJEEVAN,Independent,1025,9,1034,0.12,S1113
8,NOTA,None of the Above,9468,51,9519,1.13,S1113
1,DAMODAR AGARWAL,Bharatiya Janata Party,803193,4447,807640,61.92,S2023
2,C P JOSHI,Indian National Congress,449528,3506,453034,34.73,S2023
3,RAMESHWAR LAL BAIRWA,Bahujan Samaj Party,8243,40,8283,0.64,S2023
4,RAJESH PATNI,Independent,8013,5,8018,0.61,S2023
5,JAYKISHAN,Viro Ke Vir Indian Party,4061,23,4084,0.31,S2023
6,MOTILAL SINGHANIA,Independent,3871,16,3887,0.3,S2023
7,NARAYAN LAL JAT,Independent,1643,41,1684,0.13,S2023
8,PAWAN KUMAR SHARMA,Right to Recall Party,1609,8,1617,0.12,S2023
9,ANURAG AROT,Independent,1406,19,1425,0.11,S2023
10,VIJAY KUMAR SONI,Bhartiya Garib Vikas Kalyan Party,1340,7,1347,0.1,S2023
11,NOTA,None of the Above,13337,39,13376,1.03,S2023
1,ANIL FIROJIYA,Bharatiya Janata Party,834374,1730,836104,62.93,S1222
2,MAHESH PARMAR,Indian National Congress,459531,713,460244,34.64,S1222
3,ADVOCATE PRAKASH CHOUHAN,Bahujan Samaj Party,9502,16,9518,0.72,S1222
4,DR. HEMANT PARMAR,Bhim Sena,4973,3,4976,0.37,S1222
5,SURESH BAGARI,Independent,2786,5,2791,0.21,S1222
6,MAHESH PARMAR,Independent,2468,8,2476,0.19,S1222
7,GANGA MALVIYA,Independent,1288,7,1295,0.1,S1222
8,ANIL,Independent,979,2,981,0.07,S1222
9,ISHWARLAL VARSHI,Independent,860,3,863,0.06,S1222
10,NOTA,None of the Above,9310,22,9332,0.7,S1222
1,BHARTI PARDHI,Bharatiya Janata Party,709939,2721,712660,51.56,S1215
2,SAMRAT ASHOK SINGH SARASWAR,Indian National Congress,536333,1815,538148,38.93,S1215
3,KANKAR MUNJARE,Bahujan Samaj Party,52883,251,53134,3.84,S1215
4,BHUVAN SINGH KORAM,Independent,13028,46,13074,0.95,S1215
5,NANDLAL UIKEY,Gondvana Gantantra Party,12338,84,12422,0.9,S1215
6,D.L. MANESHWAR,Peoples Party of India (Democratic),9994,23,10017,0.72,S1215
7,DHANENDRA DEV PAWAR BANWARI SETH,Independent,7185,60,7245,0.52,S1215
8,MAHADEV NAGDEVE,Independent,7181,11,7192,0.52,S1215
9,RAJKUMAR NAGESHWER,Independent,6723,5,6728,0.49,S1215
10,MOHAN RAUT,Rashtravadi Bharat Party,3537,5,3542,0.26,S1215
11,PRIYANKA SANJAY BHANDARKAR,Bhartiya Shakti Chetna Party,2906,20,2926,0.21,S1215
12,ADVOCATE SATYAPRAKASH SHULKE (LODHI),Madhya Pradesh Jan Vikas Party,1929,3,1932,0.14,S1215
13,DILEEP CHHABDA,Independent,1733,17,1750,0.13,S1215
14,NOTA,None of the Above,11479,31,11510,0.83,S1215
1,KANIMOZHI KARUNANIDHI,Dravida Munnetra Kazhagam,537879,2850,540729,55.26,S2236
2,SIVASAMY VELUMANI R,All India Anna Dravida Munnetra Kazhagam,147407,584,147991,15.12,S2236
3,VIJAYASEELAN SDR,Tamil Maanila Congress  (Moopanar),121680,700,122380,12.51,S2236
4,ROWENA RUTH JANE J,Naam Tamilar Katchi,119374,926,120300,12.29,S2236
5,RAJHA N P,Naam Indiar Party,6622,18,6640,0.68,S2236
6,ARUNADEVI R,Independent,6029,43,6072,0.62,S2236
7,CHITHIRAI JEGAN S,Independent,3637,3,3640,0.37,S2236
8,SIVANESWARAN J,Independent,3363,13,3376,0.35,S2236
9,SAMUEL T,Independent,2240,5,2245,0.23,S2236
10,MANIKKARAJ A,Bahujan Samaj Party,2158,37,2195,0.22,S2236
11,AASIRIYAR SHANMUGA SUNDARAM K,Independent,1832,7,1839,0.19,S2236
12,KALEERMURUGAPAVENTHAN R,Makkal Nalvaazhvuk Katchi,1736,56,1792,0.18,S2236
13,PONKUMARAN T P S,Independent,894,3,897,0.09,S2236
14,JEYAKUMAR C,Independent,825,4,829,0.08,S2236
15,GANDHIMALLAR S M,Independent,791,14,805,0.08,S2236
16,BISHOP DR GODFREY NOBLE,Aanaithinthiya Jananayaka Pathukappu Kazhagam,757,12,769,0.08,S2236
17,PERUMALKUMAR P,Puthiya Makkal Tamil Desam Katchi,727,12,739,0.08,S2236
18,ESAKKIMUTHU V,Independent,699,11,710,0.07,S2236
19,KANNAN G,Independent,679,10,689,0.07,S2236
20,DAVID JEBASEELAN J,Independent,656,7,663,0.07,S2236
21,SUDALAIMUTHU P,Independent,576,2,578,0.06,S2236
22,KRISHNAN S,Independent,479,1,480,0.05,S2236
23,RADHAKRISHNAN V G,Independent,456,5,461,0.05,S2236
24,JAMES P,Independent,433,11,444,0.05,S2236
25,PONRAJ K,Independent,428,1,429,0.04,S2236
26,PRASANNA KUMAR M,Independent,396,0,396,0.04,S2236
27,SELVAMUTHUKUMAR M,Independent,341,0,341,0.03,S2236
28,SENTHIL KUMAR S,Independent,290,1,291,0.03,S2236
29,NOTA,None of the Above,9682,124,9806,1,S2236
1,BHAUSAHEB RAJARAM WAKCHAURE,Shiv Sena (Uddhav Balasaheb Thackrey),475637,1263,476900,45,S1338
2,LOKHANDE SADASHIV KISAN,Shiv Sena,425498,873,426371,40.23,S1338
3,UTKARSHA PREMANAND RUPWATE,Vanchit Bahujan  Aaghadi,90748,181,90929,8.58,S1338
4,BHAUSAHEB RAMNATH WAKCHAURE,Independent,13973,33,14006,1.32,S1338
5,RAMCHANDRA NAMDEV JADHAV,Bahujan Samaj Party,7000,40,7040,0.66,S1338
6,RAVINDRA KALLAYYA SWAMY,Independent,5536,1,5537,0.52,S1338
7,ABHIJEET ASHOKRAO POTE,Independent,4761,15,4776,0.45,S1338
8,BHARAT SAMBHAJI BHOSLE,Samata Party,3395,8,3403,0.32,S1338
9,SATISH BHIVA PAWAR,Independent,2765,6,2771,0.26,S1338
10,GANGADHAR RAJARAM KADAM,Independent,2743,14,2757,0.26,S1338
11,BAGUL GORAKSHA TANHAJI,Independent,2658,2,2660,0.25,S1338
12,PRASHANT VASANT NIKAM,Independent,2542,3,2545,0.24,S1338
13,ADV NITIN DADAHARI POL,Bahujan Bharat Party,2517,15,2532,0.24,S1338
14,RAJENDRA RATNAKAR WAGHMARE,Rashtriya Jankranti Party,2500,5,2505,0.24,S1338
15,ADV SIDHARTH DEEPAK BODHAK,Independent,2202,2,2204,0.21,S1338
16,CHANDRAKANT SAMBHAJI DONDE,Independent,2074,6,2080,0.2,S1338
17,ASHOK RAMCHANDRA ALHAT,Independent,1794,4,1798,0.17,S1338
18,KHAJEKAR VIJAYRAO GOVINDRAO,Independent,1555,2,1557,0.15,S1338
19,KHARAT NACHIKET RAGHUNATH,Independent,1146,4,1150,0.11,S1338
20,SANJAY POPAT BHALERAO,Independent,958,5,963,0.09,S1338
21,NOTA,None of the Above,5326,54,5380,0.51,S1338
1,SANDHYA RAY,Bharatiya Janata Party,533462,3603,537065,51.2,S122
2,PHOOL SINGH BARAIYA,Indian National Congress,470169,2056,472225,45.02,S122
3,DEVASHISH JARARIYA,Bahujan Samaj Party,20322,143,20465,1.95,S122
4,UMESH GARG,Independent,5057,15,5072,0.48,S122
5,REKHA SHAKYA,Independent,2645,22,2667,0.25,S122
6,HARIMOHAN,Independent,2598,12,2610,0.25,S122
7,RAKESH,Independent,2345,24,2369,0.23,S122
8,NOTA,None of the Above,6486,48,6534,0.62,S122
1,RAMESH JIGAJINAGI,Bharatiya Janata Party,669055,3726,672781,51.91,S104
2,RAJU ALAGUR.,Indian National Congress,593277,2275,595552,45.95,S104
3,GANAPATI  RATHOD (HANJAGI),Karnataka Rashtra Samithi,7652,39,7691,0.59,S104
4,BHOVI TARABAI,Independent,4342,11,4353,0.34,S104
5,RAMJI YAMANAPPA BUDDHAPRIYA,Naki Bharatiya Ekta Party,2414,12,2426,0.19,S104
6,NAGAJYOTI.B.N.,Socialist Unity Centre Of India (COMMUNIST),2375,17,2392,0.18,S104
7,RAJAKUMAR APPANNA HONNAKATTI,Rashtriya Samaj Paksha,1784,10,1794,0.14,S104
8,JITENDRA.ASHOK. KAMBLE,Republican Party of India (A),1605,18,1623,0.13,S104
9,NOTA,None of the Above,7482,20,7502,0.58,S104
1,BIPLAB KUMAR DEB,Bharatiya Janata Party,868484,12857,881341,72.85,S231
2,ASISH KUMAR SAHA,Indian National Congress,265912,3851,269763,22.3,S231
3,RAMENDRA REANG,Independent,8899,33,8932,0.74,S231
4,ARUN KUMAR BHAUMIK,Socialist Unity Centre Of India (COMMUNIST),8617,167,8784,0.73,S231
5,GOURI SANKAR NANDI,Independent,8074,40,8114,0.67,S231
6,MILAN PADA MURASING,Independent,6625,27,6652,0.55,S231
7,BALARAM DEBBARMA,Independent,4356,123,4479,0.37,S231
8,BRAJALAL DEBNATH,Independent,3656,27,3683,0.3,S231
9,ARNAB ROY,Republican Party of India (A),3420,29,3449,0.29,S231
10,NOTA,None of the Above,14444,168,14612,1.21,S231
1,ABHISHEK BANERJEE,All India Trinamool Congress,1043493,4737,1048230,68.48,S2521
2,ABHIJIT DAS (BOBBY),Bharatiya Janata Party,336068,1232,337300,22.03,S2521
3,PRATIK UR RAHAMAN,Communist Party of India  (Marxist),86507,446,86953,5.68,S2521
4,MAJNU LASKAR,All India Secular Front,21109,30,21139,1.38,S2521
5,SUBRATA BOSE,Independent,9819,6,9825,0.64,S2521
6,DASARATHI PAIK,Bahujan Samaj Party,7082,29,7111,0.46,S2521
7,MALAY GUHA ROY,Independent,2963,8,2971,0.19,S2521
8,PULAKESH MONDAL,Independent,1945,3,1948,0.13,S2521
9,KALIMUDDIN SK,Indian National Socialistic Action Forces,1579,11,1590,0.1,S2521
10,RAMKUMAR MONDAL,Socialist Unity Centre Of India (COMMUNIST),1411,7,1418,0.09,S2521
11,ANISUR RAHAMAN SK,Independent,1152,7,1159,0.08,S2521
12,KASHINATH MONDAL,Independent,961,24,985,0.06,S2521
13,NOTA,None of the Above,10134,54,10188,0.67,S2521
1,NARAYAN TATU RANE,Bharatiya Janata Party,445339,3175,448514,49.07,S1346
2,VINAYAK BHAURAO RAUT,Shiv Sena (Uddhav Balasaheb Thackrey),396524,4132,400656,43.83,S1346
3,VINAYAK LAVU RAUT,Independent,15769,57,15826,1.73,S1346
4,MARUTI RAMACHANDRA JOSHI,Vanchit Bahujan  Aaghadi,9873,166,10039,1.1,S1346
5,AAYARE RAJENDRA LAHU,Bahujan Samaj Party,7796,60,7856,0.86,S1346
6,SHAKIL SAWANT,Independent,6373,22,6395,0.7,S1346
7,TAMBADE AMRUT ANANT (RAJAPURKAR),Independent,5563,19,5582,0.61,S1346
8,ASHOK GANGARAM PAWAR,Bahujan Mukti Party,5244,36,5280,0.58,S1346
9,SURESH GOVINDRAO SHINDE,Sainik Samaj Party,2209,38,2247,0.25,S1346
10,NOTA,None of the Above,11516,127,11643,1.27,S1346
1,KALIPADA SAREN (KHERWAL),All India Trinamool Congress,740132,3346,743478,49.87,S2533
2,DR. PRANAT TUDU,Bharatiya Janata Party,566553,2877,569430,38.2,S2533
3,SONAMANI TUDU,Communist Party of India  (Marxist),76850,452,77302,5.19,S2533
4,SURYA SINGH BESRA,Jharkhand People's Party,19408,86,19494,1.31,S2533
5,BARUN MAHATO,Independent,12029,58,12087,0.81,S2533
6,ARUNKUMAR HANSDA,Bahujan Samaj Party,11949,40,11989,0.8,S2533
7,SURENDRANATH SING,Independent,10781,6,10787,0.72,S2533
8,RAMANATH ORANG,Independent,7178,10,7188,0.48,S2533
9,BIPLAB HEMBRAM,Independent,7156,14,7170,0.48,S2533
10,BAPI SOREN,All India Secular Front,5854,41,5895,0.4,S2533
11,BIRSABIR BASKEY,Ambedkarite Party of India,4344,18,4362,0.29,S2533
12,SUSHIL MANDI,Socialist Unity Centre Of India (COMMUNIST),2879,13,2892,0.19,S2533
13,GUNADHAR SING,Independent,2818,31,2849,0.19,S2533
14,NOTA,None of the Above,15871,49,15920,1.07,S2533
1,PUTTA MAHESH KUMAR,Telugu Desam,737644,8707,746351,54,S0110
2,KARUMURI SUNIL KUMAR,Yuvajana Sramika Rythu Congress Party,559318,5176,564494,40.84,S0110
3,KAVURI LAVANYA,Indian National Congress,19820,1006,20826,1.51,S0110
4,AJAY BABU BODA,Navarang Congress Party,12197,13,12210,0.88,S0110
5,NITTA AKHILA DHARANI PAL,Bahujan Samaj Party,6664,68,6732,0.49,S0110
6,BOKINALA KOTESWARA RAO,Independent,2253,10,2263,0.16,S0110
7,RUDRAPAKA RATNA RAO (R.R.R),Andhra Rastra Praja Samithi,1523,3,1526,0.11,S0110
8,KANDAVALLI JEEVA DEVA DAYAKAR,Independent,1172,8,1180,0.09,S0110
9,AGASTEEN KOMMINA,Independent,1001,3,1004,0.07,S0110
10,DR. MENDEM SANTHOSH KUMAR (PEDDA BABULU),Liberation Congress Party,777,9,786,0.06,S0110
11,RAJESWARA RAO KONDRU,Bharatheeya Jawan Kisan Party,729,3,732,0.05,S0110
12,GODUGUPATI VEERA RAGHAVULU,Pyramid Party of India,710,5,715,0.05,S0110
13,BYRABOYINA MALYADRI,Bharatha Chaitanya Yuvajana Party,705,10,715,0.05,S0110
14,NOTA,None of the Above,22371,144,22515,1.63,S0110
1,VEENA DEVI,Lok Janshakti Party(Ram Vilas),566225,818,567043,48.38,S0416
2,VIJAY KUMAR SHUKLA,Rashtriya Janata Dal,476199,1210,477409,40.73,S0416
3,VIKKY KUMAR,Independent,34253,3,34256,2.92,S0416
4,SHAMBHU KUMAR SINGH,Bahujan Samaj Party,21367,69,21436,1.83,S0416
5,RAJ NARAYAN YADAV,Independent,9614,2,9616,0.82,S0416
6,PARAMHANS SINGH,Independent,5316,1,5317,0.45,S0416
7,HARI NARAYAN RAM,Viro Ke Vir Indian Party,5097,3,5100,0.44,S0416
8,RAMESHWAR MAHTO,Bhartiya Sarthak Party,4141,9,4150,0.35,S0416
9,KUMAR SHISHIR,Independent,3903,4,3907,0.33,S0416
10,MUHAMAD AVAS,Independent,3758,0,3758,0.32,S0416
11,ABHA RAY,Peoples Party of India (Democratic),3263,11,3274,0.28,S0416
12,NARESH RAM,Socialist Unity Centre Of India (COMMUNIST),2998,11,3009,0.26,S0416
13,VINOD KUMAR SHARMA,Jantantra Awaj Party,2929,5,2934,0.25,S0416
14,ANIKET RAJ,Rashtriya Samaj Paksha,2018,7,2025,0.17,S0416
15,BALENDRA TIWARY,Hindustan Janta Party Secular,1360,6,1366,0.12,S0416
16,NOTA,None of the Above,27420,40,27460,2.34,S0416
1,SAMBIT PATRA,Bharatiya Janata Party,625372,3958,629330,52.58,S1817
2,ARUP MOHAN PATNAIK,Biju Janata Dal,523036,1585,524621,43.83,S1817
3,JAYANARAYAN PATTANAYAK,Indian National Congress,24066,276,24342,2.03,S1817
4,SANTANU KUMAR DAS,Bahujan Samaj Party,3918,11,3929,0.33,S1817
5,SUBASH CHANDRA BHOI,Socialist Unity Centre Of India (COMMUNIST),3257,9,3266,0.27,S1817
6,SOBHA PANDEY,Independent,2212,17,2229,0.19,S1817
7,DILLIP KUMAR BARAL,Independent,1605,6,1611,0.13,S1817
8,NOTA,None of the Above,7568,42,7610,0.64,S1817
1,APPALANAIDU KALISETTI,Telugu Desam,729284,13829,743113,57.2,S013
2,BELLANA CHANDRASEKHAR,Yuvajana Sramika Rythu Congress Party,487691,6071,493762,38,S013
3,BOBBILI SRINU,Indian National Congress,10270,353,10623,0.82,S013
4,PEERUBANDI PRAKASH RAO,Bahujan Samaj Party,7985,53,8038,0.62,S013
5,VELURI VENKATA TRINADHARAO,Independent,4146,6,4152,0.32,S013
6,ALLU SRIRAMULU,Independent,3396,5,3401,0.26,S013
7,SIYYADULA YELLA RAO,Independent,3105,2,3107,0.24,S013
8,SRINIVASA RAO SAMBHANA,Yuga Thulasi Party,1758,3,1761,0.14,S013
9,MARISERLA KRISHNAMURTHY NAIDU,Independent,1617,12,1629,0.13,S013
10,VANGAPANDU MAHESWARA RAO,Naba Bharata Nirmana Seva Party,1544,9,1553,0.12,S013
11,CHINNAM ARUNA KUMAR,Jaibhim Rao Bharat Party,1401,10,1411,0.11,S013
12,ATCHIYYA NAIDU SAMIREDDY,Samajwadi Party,1059,11,1070,0.08,S013
13,ADINARAYANA TADDI,Independent,855,1,856,0.07,S013
14,P V A ANANDA SAGAR,Independent,787,4,791,0.06,S013
15,SAKHINETI ANANTHA RAJU,Pyramid Party of India,715,10,725,0.06,S013
16,NOTA,None of the Above,23097,153,23250,1.79,S013
1,DARSHAN SINGH CHOUDHARY,Bharatiya Janata Party,810529,1618,812147,64.99,S1217
2,SANJAY SHARMA SANJU BHAIYA,Indian National Congress,379868,583,380451,30.44,S1217
3,RAMGOVIND BARUAA,Bahujan Samaj Party,15344,43,15387,1.23,S1217
4,PANDIT DIVYENDRA BRIJMOHAN DUBEY ADVOCATE,Bharatiya Yuva Jan Ekta Party,6157,11,6168,0.49,S1217
5,RAKESH RAMPRASAD RICKY,Independent,5071,8,5079,0.41,S1217
6,SARJERAO SAHARE,Independent,4487,6,4493,0.36,S1217
7,PATRAKAR TILAK JATAV,Independent,2257,3,2260,0.18,S1217
8,YUVRAJ GAVADE,Independent,2205,10,2215,0.18,S1217
9,JYOTI SURESH JHARIYA,Independent,2033,13,2046,0.16,S1217
10,MAKHAN SINGH LODHI,Bhartiya Shakti Chetna Party,1651,6,1657,0.13,S1217
11,MUKESH YADAV,Independent,1578,10,1588,0.13,S1217
12,PANDIT BRAJESH KHEMARIYA,Independent,1251,9,1260,0.1,S1217
13,NOTA,None of the Above,14927,14,14941,1.2,S1217
1,MANICKAM TAGORE B,Indian National Congress,382876,2380,385256,36.28,S2234
2,VIJAYAPRABHAKARAN V,Desiya Murpokku Dravida Kazhagam,378243,2634,380877,35.87,S2234
3,RADIKAA R,Bharatiya Janata Party,164149,2122,166271,15.66,S2234
4,KAUSHIK S,Naam Tamilar Katchi,76122,909,77031,7.25,S2234
5,RAJESH,Independent,6167,6,6173,0.58,S2234
6,ASHOK KUMAR M,Bharatiya Praja Aikyata Party,5228,65,5293,0.5,S2234
7,SEKAR S,Hindu Samaj Party,3436,10,3446,0.32,S2234
8,MANIKANDAN M,Independent,3341,5,3346,0.32,S2234
9,MAYAK KANNAN,Independent,2749,2,2751,0.26,S2234
10,MAHENDRA RAMAKRISHNAN P,Independent,2404,1,2405,0.23,S2234
11,SURESH,Bahujan Samaj Party,2378,19,2397,0.23,S2234
12,SELVI K,Independent,2165,23,2188,0.21,S2234
13,PANDIYAMMAL R,Independent,2128,5,2133,0.2,S2234
14,SUDALAIMANI M,Independent,1357,2,1359,0.13,S2234
15,PALANICHAMY P,Bahujan Dravida Party,1261,2,1263,0.12,S2234
16,PALANISAMY K,Independent,1251,6,1257,0.12,S2234
17,VENKATESWARAN V K,Independent,1242,5,1247,0.12,S2234
18,SELVARAJAN V V,Independent,1120,1,1121,0.11,S2234
19,MARIEESWARI M,Independent,1100,10,1110,0.1,S2234
20,SANKARANARAYANAN N,Independent,994,4,998,0.09,S2234
21,SELVAKUMAR M,Independent,896,6,902,0.08,S2234
22,MUTHUKANNU C,Tamilaga Makkal Nala Katchi,753,8,761,0.07,S2234
23,MARISELVAM S,All India People Development Party,708,3,711,0.07,S2234
24,JEYARAJ T,Independent,602,8,610,0.06,S2234
25,VEDHA @  DHAMODHARAN,Independent,599,1,600,0.06,S2234
26,RAJAGOPAL S,Independent,525,2,527,0.05,S2234
27,GANESHAMOORTHI G,Independent,457,3,460,0.04,S2234
28,NOTA,None of the Above,9256,152,9408,0.89,S2234
1,JUNE MALIAH,All India Trinamool Congress,699562,2630,702192,47.4,S2534
2,AGNIMITRA PAUL,Bharatiya Janata Party,671328,3673,675001,45.56,S2534
3,BIPLAB BHATTA,Communist Party of India,57345,440,57785,3.9,S2534
4,ANINDITA JANA,Socialist Unity Centre Of India (COMMUNIST),9744,47,9791,0.66,S2534
5,SANJIB DEY,Independent,8703,8,8711,0.59,S2534
6,ANJAN (BABALU) MANDAL,Bahujan Samaj Party,6483,20,6503,0.44,S2534
7,KAMALESH MAHATA,Independent,4229,21,4250,0.29,S2534
8,SUKESH CHANDRA PALMAL,Independent,2757,5,2762,0.19,S2534
9,BISWAJIT DAS,Independent,2141,3,2144,0.14,S2534
10,NOTA,None of the Above,12362,62,12424,0.84,S2534
1,ARUP CHAKRABORTY,All India Trinamool Congress,637465,4348,641813,44.33,S2536
2,DR. SUBHAS SARKAR,Bharatiya Janata Party,604836,4199,609035,42.07,S2536
3,NILANJAN DASGUPTA,Communist Party of India  (Marxist),104534,825,105359,7.28,S2536
4,SURAJIT SINGH KURMALI,Independent,18507,62,18569,1.28,S2536
5,GOPAL MURMU,Ambedkarite Party of India,9047,54,9101,0.63,S2536
6,DIPA BOURI,Bahujan Samaj Party,8709,87,8796,0.61,S2536
7,MARSHAL TUDU,Independent,6682,35,6717,0.46,S2536
8,TARA SHANKAR GOPE,Socialist Unity Centre Of India (COMMUNIST),5490,39,5529,0.38,S2536
9,SANDIP KUMAR DEY,Independent,4610,12,4622,0.32,S2536
10,SAMAR KUMAR BISWAS,Kisan Mazdoor Sangharsh Party,3512,29,3541,0.24,S2536
11,JIBAN CHAKRABORTY,Independent,3483,23,3506,0.24,S2536
12,KARTIK CHANDRA BAURI,Independent,2741,55,2796,0.19,S2536
13,GOUR CHANDRA HEMBRAM,Independent,2064,17,2081,0.14,S2536
14,NOTA,None of the Above,26126,83,26209,1.81,S2536
1,RAVINDRA SHUKLA ALIAS RAVI KISHAN,Bharatiya Janata Party,584512,1322,585834,50.75,S2464
2,KAJAL NISHAD,Samajwadi Party,480788,1520,482308,41.78,S2464
3,JAVED ASHRAF ALIAS JAVED SIMNANI,Bahujan Samaj Party,55660,121,55781,4.83,S2464
4,ANAND KUMAR YADAV ALIAS ANAND KUMAR FAUJI,Bharatheeya Jawan Kisan Party,4946,9,4955,0.43,S2464
5,PINTU SAHANI,Independent,4031,1,4032,0.35,S2464
6,SHIVSHANKAR PRAJAPATI,Bhagidari Party(P),2631,4,2635,0.23,S2464
7,SUDHANSHU,Independent,2393,2,2395,0.21,S2464
8,SANJAY SINGH RANA,Bhartiya Sarvdharm Party,2011,1,2012,0.17,S2464
9,NAFEES AKHTAR,Independent,1880,0,1880,0.16,S2464
10,ANKIT SHAH,Bharatiya Yuva Jan Ekta Party,1871,3,1874,0.16,S2464
11,AMITA BHARATI,Independent,1356,8,1364,0.12,S2464
12,SONU RAI,Mera Adhikaar Rashtriya Dal,891,7,898,0.08,S2464
13,SHRIRAM PRASAD,Al-Hind Party,762,2,764,0.07,S2464
14,NOTA,None of the Above,7652,29,7681,0.67,S2464
1,NABA CHARAN MAJHI,Bharatiya Janata Party,580579,5392,585971,49.91,S185
2,SUDAM MARNDI,Biju Janata Dal,364745,1892,366637,31.23,S185
3,ANJANI SOREN,Jharkhand Mukti Morcha,134713,686,135399,11.53,S185
4,RABINDRA NATH SINGH,Independent,9282,42,9324,0.79,S185
5,ASHOK KUMAR SING,Independent,8918,35,8953,0.76,S185
6,JATIA SAWAYAN,Bahujan Samaj Party,8457,45,8502,0.72,S185
7,SANTILATA CHATTAR,Independent,8448,29,8477,0.72,S185
8,PITAMBAR NAIK,Socialist Unity Centre Of India (COMMUNIST),8070,44,8114,0.69,S185
9,ANTA ALOK BASKEY,AJSU Party,5386,8,5394,0.46,S185
10,BAJUN HANSDA,Independent,5304,18,5322,0.45,S185
11,KANHU CHARAN TUDU,Independent,5103,35,5138,0.44,S185
12,SUKANTA HEMBRAM,Bharatiya Nyay-Adhikar Raksha Party,3636,20,3656,0.31,S185
13,GURU  CHARAN HEMBRAM,Bharatheeya Jawan Kisan Party,3175,35,3210,0.27,S185
14,NOTA,None of the Above,19853,100,19953,1.7,S185
1,PRADAN BARUAH,Bharatiya Janata Party,659307,3815,663122,54.75,S0312
2,UDAY SHANKAR HAZARIKA,Indian National Congress,458720,3145,461865,38.13,S0312
3,DHIREN KACHARI,Communist Party of India,19562,69,19631,1.62,S0312
4,GHANA KANTA CHUTIA,All India Trinamool Congress,14055,142,14197,1.17,S0312
5,BIKRAM RAMCHIARY,Independent,10218,75,10293,0.85,S0312
6,GOBIN BISWAKARMA,Independent,7461,65,7526,0.62,S0312
7,DEBA NATH PAIT,Independent,6143,20,6163,0.51,S0312
8,PALLAB PEGU,Socialist Unity Centre Of India (COMMUNIST),6051,86,6137,0.51,S0312
9,BIREN BAILUNG,Voters Party  International,5329,30,5359,0.44,S0312
10,NOTA,None of the Above,16716,205,16921,1.4,S0312
1,K.RADHAKRISHNAN,Communist Party of India  (Marxist),398818,4629,403447,40.66,S119
2,RAMYA HARIDAS,Indian National Congress,379231,4105,383336,38.63,S119
3,DR T N SARASU,Bharatiya Janata Party,186441,1789,188230,18.97,S119
4,HARI ARUMBIL,Bahujan Samaj Party,2835,36,2871,0.29,S119
5,KRISHNANKUTTY KUNISSERY,Independent,2323,28,2351,0.24,S119
6,NOTA,None of the Above,11918,115,12033,1.21,S119
1,SUDHA R,Indian National Congress,516534,1925,518459,47.67,S2228
2,BABU P,All India Anna Dravida Munnetra Kazhagam,246083,1193,247276,22.73,S2228
3,STALIN M K,Pattali Makkal Katchi,165770,667,166437,15.3,S2228
4,KALIYAMMAL P,Naam Tamilar Katchi,127276,366,127642,11.73,S2228
5,KARTHICK A,Samaniya Makkal Nala Katchi,3888,3,3891,0.36,S2228
6,ILANCHEZHIAN T,Bahujan Samaj Party,2878,20,2898,0.27,S2228
7,BABU S,Independent,1832,6,1838,0.17,S2228
8,MANIMARAN T,Independent,1710,1,1711,0.16,S2228
9,NAGARAJAN K,Independent,1342,5,1347,0.12,S2228
10,SILAMBARASAN D,Independent,1255,1,1256,0.12,S2228
11,JAFARULLAH KHAN F,Independent,1230,6,1236,0.11,S2228
12,PANDIYARAJAN S,Independent,1169,5,1174,0.11,S2228
13,TIMOTHY T,Independent,1165,10,1175,0.11,S2228
14,VEDARETHINAM S,Anna MGR Dravida Makkal Kalgam,780,2,782,0.07,S2228
15,NITHIYANANTHAM S,Naadaalum Makkal Katchi,735,4,739,0.07,S2228
16,SRINIVASAN V,Independent,609,8,617,0.06,S2228
17,DHAKSHINAMOORTHY M,Independent,518,17,535,0.05,S2228
18,NOTA,None of the Above,8642,53,8695,0.8,S2228
1,P V MIDHUN REDDY,Yuvajana Sramika Rythu Congress Party,639111,5733,644844,48.38,S0124
2,NALLARI KIRAN KUMAR REDDY,Bharatiya Janata Party,557030,11743,568773,42.67,S0124
3,SHAIK BASHEED,Indian National Congress,52229,1071,53300,4,S0124
4,ABBAVARAM UGENDRA,Bahujan Samaj Party,12306,57,12363,0.93,S0124
5,POOLA REDDY SEKHAR,Independent,6097,3,6100,0.46,S0124
6,NAGARAJU JETTI,Independent,5984,15,5999,0.45,S0124
7,PRADEEP PENAMADU,All India Forward Bloc,5671,1,5672,0.43,S0124
8,CHOUDVARAM SUBBANARASAIAH,Independent,4731,4,4735,0.36,S0124
9,PULI SREENIVASULU,Independent,4613,3,4616,0.35,S0124
10,SREENIVASULU MARRIPATI,Independent,4436,7,4443,0.33,S0124
11,AKBAR M BASHA,Anna YSR Congress Party,2394,17,2411,0.18,S0124
12,SANGARAJU NAGESWARA RAJU,Independent,1523,12,1535,0.12,S0124
13,MADA RAJA,Jaathia Chethi Vruthula Ikya Vedika Party,1415,0,1415,0.11,S0124
14,BATTHALA RAMANAIAH,Jai Bharat National Party,1360,6,1366,0.1,S0124
15,DODDAPANENI RAJA NAIDU,Independent,1315,3,1318,0.1,S0124
16,MAYANA MOHAMMED SALMAN KHAN,Liberation Congress Party,1069,2,1071,0.08,S0124
17,KASTURI OBAIAH NAIDU,Independent,885,2,887,0.07,S0124
18,ASADI VENKATADRI,Independent,689,2,691,0.05,S0124
19,NOTA,None of the Above,11324,76,11400,0.86,S0124
1,ABHIJIT GANGOPADHYAY,Bharatiya Janata Party,761183,4401,765584,48.54,S2530
2,DEBANGSHU BHATTACHARYA,All India Trinamool Congress,683955,3896,687851,43.61,S2530
3,SAYAN BANERJEE,Communist Party of India  (Marxist),84774,615,85389,5.41,S2530
4,MOHIUDDIN AHMED MAHI,All India Secular Front,12303,36,12339,0.78,S2530
5,SURYANEEL DAS,Independent,6012,2,6014,0.38,S2530
6,NARAYAN CHANDRA NAYAK,Socialist Unity Centre Of India (COMMUNIST),5633,49,5682,0.36,S2530
7,SABITRI BISHAI,Bahujan Samaj Party,3724,30,3754,0.24,S2530
8,DEBAPRASAD JANA,Independent,1460,7,1467,0.09,S2530
9,KALIPADA DAS,Independent,947,27,974,0.06,S2530
10,NOTA,None of the Above,8223,42,8265,0.52,S2530
1,ARUN BHARTI,Lok Janshakti Party(Ram Vilas),508179,867,509046,51.98,S0440
2,ARCHANA KUMARI,Rashtriya Janata Dal,395696,868,396564,40.5,S0440
3,SUBHASH PASWAN,Independent,13841,34,13875,1.42,S0440
4,SAKALDEO DAS,Bahujan Samaj Party,12313,53,12366,1.26,S0440
5,SRAWON KUMAR,Rashtriya Jansambhavna Party,8604,21,8625,0.88,S0440
6,JAGDISH PRASAD,Loktantrik Samajik Nyay Party,6532,10,6542,0.67,S0440
7,SANTOSH KUMAR DAS,Socialist Unity Centre Of India (COMMUNIST),6025,8,6033,0.62,S0440
8,NOTA,None of the Above,26148,34,26182,2.67,S0440
1,VAMSI KRISHNA GADDAM,Indian National Congress,470180,5407,475587,43.42,S292
2,SRINIVAS GOMASE,Bharatiya Janata Party,339107,5116,344223,31.43,S292
3,ESHWAR KOPPULA,Bharat Rashtra Samithi,191891,1465,193356,17.65,S292
4,ERUKULLA RAJA NARSAIAH,Bahujan Samaj Party,6730,69,6799,0.62,S292
5,VENUGOPAL MOYYI,Bahujan Mukti Party,5220,3,5223,0.48,S292
6,MOTHE NARESH,Peoples Party of India (Democratic),4998,9,5007,0.46,S292
7,RAMESH MANDA,Dharma Samaj Party,4314,20,4334,0.4,S292
8,AMBOJU SUMALATHA,Alliance of Democratic Reforms Party,3770,13,3783,0.35,S292
9,DURGAM RAMULU,Independent,3432,2,3434,0.31,S292
10,MULKALLA RAJENDRAPRASAD,Independent,2786,3,2789,0.25,S292
11,RAMCHANDAR NICHHAKOLA,Dalita Bahujana Party,2589,40,2629,0.24,S292
12,KANDI CHANDU,Rashtriya Manav Party,2409,1,2410,0.22,S292
13,RAMULA KARTHIK,Independent,2284,4,2288,0.21,S292
14,MOLUGU VENKATESH,New India Party,2234,35,2269,0.21,S292
15,ERUGURALA BHAGYALAXMI,Pyramid Party of India,2113,12,2125,0.19,S292
16,GADDAM MARUTHI,Independent,2073,8,2081,0.19,S292
17,NAVEEN NUKALA,Independent,2057,10,2067,0.19,S292
18,MEKALA AKSHAY KUMAR,Independent,1899,3,1902,0.17,S292
19,KATKURI SANDEEP,Independent,1867,5,1872,0.17,S292
20,BOTLA CHANDRAIAH,Independent,1744,3,1747,0.16,S292
21,ERIKILLA RAJESH,Independent,1731,3,1734,0.16,S292
22,AKKAPAKA THIRUPATHI,Independent,1662,7,1669,0.15,S292
23,DURGAM SANTHOSH,Prajarajya Samithi,1576,38,1614,0.15,S292
24,MAMIDIPALLY BAPAIAH,Independent,1501,3,1504,0.14,S292
25,DUDA MAHIPAL,Independent,1495,1,1496,0.14,S292
26,BOODIDHA THIRUPATHI,Independent,1392,1,1393,0.13,S292
27,DAGAM SRINIVAS,Independent,1384,4,1388,0.13,S292
28,KADASI SHEKHAR,Independent,1266,6,1272,0.12,S292
29,DR VASARLA NATHANIAL,Independent,1195,22,1217,0.11,S292
30,AARNAKONDA RAJU,Independent,1160,7,1167,0.11,S292
31,NARESH JANAGAMA,Independent,1117,6,1123,0.1,S292
32,CHILUKA ANAND,Yuva Taram Party,1089,4,1093,0.1,S292
33,TALLAPALLY NARESH,Independent,967,1,968,0.09,S292
34,KURMA MAHENDER,Independent,863,2,865,0.08,S292
35,CHANDANAGIRI SHRINIVAS,Independent,766,0,766,0.07,S292
36,KASHI SATHISH KUMAR,Anti Corruption Dynamic Party,745,6,751,0.07,S292
37,KANAKAIAH MULKALA,Socialist Party (India),709,11,720,0.07,S292
38,SRINIVAS PANTHUKALA,Independent,701,2,703,0.06,S292
39,KONKATI LINGA MURTHI,Independent,659,2,661,0.06,S292
40,JUPAKA KIRAN,Independent,649,4,653,0.06,S292
41,RAJKUMAR DURGAM,Independent,478,1,479,0.04,S292
42,RAJESHAM RACHARLA,Independent,422,1,423,0.04,S292
43,NOTA,None of the Above,5591,120,5711,0.52,S292
1,MADHAVANENI RAGHUNANDAN RAO,Bharatiya Janata Party,463777,7440,471217,33.99,S296
2,NEELAM MADHU,Indian National Congress,427899,4179,432078,31.17,S296
3,P. VENKATRAMA REDDY,Bharat Rashtra Samithi,395250,1540,396790,28.62,S296
4,NANDA KISHORE TALLADA,Alliance of Democratic Reforms Party,17191,25,17216,1.24,S296
5,SARA YADAGIRI GOUD,Praja Velugu Party,11056,4,11060,0.8,S296
6,BODAPATLA ESHWAR,Bahujan Samaj Party,7423,40,7463,0.54,S296
7,DUBALA SRI SAILAM,Independent,5161,5,5166,0.37,S296
8,ADLA KUMAR,Independent,5113,3,5116,0.37,S296
9,BANDAPALLY SRINIVAS,Socialist Unity Centre Of India (COMMUNIST),2366,0,2366,0.17,S296
10,ANIL GOUD,Bharat Jodo Party,2128,4,2132,0.15,S296
11,ABHILASH CHELIMELA,Independent,2031,0,2031,0.15,S296
12,ATI ANJANEYULU,Independent,2029,9,2038,0.15,S296
13,MAISANGARI SUNIL,India Praja Bandhu Party,2009,2,2011,0.15,S296
14,PRADEEP,Independent,2006,4,2010,0.14,S296
15,INDRAGOUD SILIVERI,National Nava Kranthi Party,1773,1,1774,0.13,S296
16,NAGAMANI ACHA,Independent,1538,2,1540,0.11,S296
17,A. KRANTHI KUMAR,Independent,1465,2,1467,0.11,S296
18,MAREPALLY LAXMINARAYANA,Independent,1411,3,1414,0.1,S296
19,BALESH UPPARI,Independent,1390,3,1393,0.1,S296
20,VENKATESH BEJUGAM,Independent,1263,1,1264,0.09,S296
21,BOMMALA VIJAY KUMAR,Independent,1194,2,1196,0.09,S296
22,ANNELA LAXMAN,Dharma Samaj Party,1143,9,1152,0.08,S296
23,ABHILASH SHIRNA,Independent,923,1,924,0.07,S296
24,DODLA VENKAT,Telangana Praja Shakthi Party,915,2,917,0.07,S296
25,ABISHEK GOUD THABETI,Jana Shankhaaraavam Party,792,5,797,0.06,S296
26,MEDI SRINIVAS REDDI,Independent,791,2,793,0.06,S296
27,VUTLA RAMESH,Independent,778,0,778,0.06,S296
28,D. NARAHARI,Independent,674,1,675,0.05,S296
29,GOLLAPALLY SAYA GOUD,Pyramid Party of India,656,2,658,0.05,S296
30,SATYANARAYANA GOUD KOVURI,Independent,607,0,607,0.04,S296
31,DASARI BHANUCHANDER,Independent,573,2,575,0.04,S296
32,DADIGE RAJENDAR,Independent,556,3,559,0.04,S296
33,C.H. NAVEEN KUMAR,Independent,529,2,531,0.04,S296
34,KONDI ASHOK,Independent,509,0,509,0.04,S296
35,URELLI YELLAIAH,Viduthalai Chiruthaigal Katchi,492,2,494,0.04,S296
36,GONDHI BHUJANGAMU,Independent,430,1,431,0.03,S296
37,MOHD AZHER,Independent,414,2,416,0.03,S296
38,S RAJESH SAGAR,Independent,348,0,348,0.03,S296
39,KASOJU SRIKANTH,Independent,344,0,344,0.02,S296
40,K. LAXMINARAYANA,Independent,317,0,317,0.02,S296
41,KOLKUR PRATAP,Independent,292,1,293,0.02,S296
42,GADILA ANJANEYULU,Independent,289,1,290,0.02,S296
43,GOUTI MALLESH,Independent,247,1,248,0.02,S296
44,K.RAGHU,Independent,222,2,224,0.02,S296
45,NOTA,None of the Above,4582,35,4617,0.33,S296
1,TRIVENDRA SINGH RAWAT,Bharatiya Janata Party,648498,5310,653808,50.19,S285
2,VIRENDRA RAWAT,Indian National Congress,487406,2346,489752,37.6,S285
3,UMESH KUMAR PATRAKAR,Independent,89958,1230,91188,7,S285
4,JAMIL AHMAD,Bahujan Samaj Party,42116,207,42323,3.25,S285
5,BALBIR SINGH BHANDARI,Uttarakhand Samanta Party,2943,18,2961,0.23,S285
6,MOHAN SINGH ASWAL,Uttarakhand Kranti Dal,2809,45,2854,0.22,S285
7,VIJAY KUMAR,Independent,2409,1,2410,0.19,S285
8,PAWAN KASHYAP,Independent,2170,8,2178,0.17,S285
9,KARAN SINGH SAINI ENGINEER,Independent,1963,11,1974,0.15,S285
10,AKRAM HUSSAIN,Independent,1678,7,1685,0.13,S285
11,LALIT KUMAR,Peoples Party of India (Democratic),1396,14,1410,0.11,S285
12,SURESH PAL,Bhartiya Rashtriya Ekta Dal,1150,12,1162,0.09,S285
13,ASHISH DHYANI,Independent,1107,10,1117,0.09,S285
14,AVNISH KUMAR,Independent,967,8,975,0.07,S285
15,NOTA,None of the Above,6663,163,6826,0.52,S285
1,KAMALJEET SEHRAWAT,Bharatiya Janata Party,838332,4326,842658,55.27,U056
2,MAHABAL MISHRA,Aam Aadmi Party,641759,1886,643645,42.22,U056
3,VISHAKHA,Bahujan Samaj Party,7899,65,7964,0.52,U056
4,SABIR KHAN,Independent,3096,1,3097,0.2,U056
5,AJ RAJAN,Navarang Congress Party,2381,6,2387,0.16,U056
6,SUNIL MEGHWAL,Ambedkarite Party of India,1874,2,1876,0.12,U056
7,OM PRAKASH NARAYAN,Aapki Apni Party (Peoples),1770,3,1773,0.12,U056
8,ANJU SHARMA,Independent,1263,4,1267,0.08,U056
9,KAPIL MARWAH,Independent,1154,1,1155,0.08,U056
10,JARNAIL SINGH,Independent,1083,6,1089,0.07,U056
11,MADHU,Akhil Bhartiya Parivar Party,1056,3,1059,0.07,U056
12,RAJIV KANT MISHRA,Independent,995,0,995,0.07,U056
13,RAMESH KUMAR JAIN @ NIRBHIK,Gareeb Aadmi Party,971,0,971,0.06,U056
14,UMA SHANKAR TIWARI,Bhartiya Mahasangh Party,753,5,758,0.05,U056
15,MEENA UJJAINWAL,Peoples Party of India (Democratic),752,4,756,0.05,U056
16,CHARANJEET SINGH,All India Forward Bloc,614,5,619,0.04,U056
17,UMESH CHAUHAN,Rashtriya Rashtrawadi Party,611,3,614,0.04,U056
18,PRAMOD KUREEL,Bahujan National Party (Ambedkar),585,1,586,0.04,U056
19,AMIT KUMAR SINGH,Rashtriya Suraksha Party,571,3,574,0.04,U056
20,JAYA RAMAN,Sarvlokhit Samaj Party,439,7,446,0.03,U056
21,RAM NARAYAN MOHANTY,Independent,433,1,434,0.03,U056
22,CHAMAN LAL VERMA,Samaj Vikas Kranti Party,418,2,420,0.03,U056
23,DEEPAK SHARMA,Bharatiya Jan Jagriti Party,362,8,370,0.02,U056
24,RAVI,Independent,280,2,282,0.02,U056
25,NOTA,None of the Above,8624,75,8699,0.57,U056
1,B.Y.RAGHAVENDRA,Bharatiya Janata Party,775731,2990,778721,56.54,S1014
2,GEETHA SHIVARAJKUMAR,Indian National Congress,533622,1384,535006,38.85,S1014
3,K. S. ESHWARAPPA,Independent,29959,91,30050,2.18,S1014
4,BANDI,Independent,7265,1,7266,0.53,S1014
5,RAVIKUMARA N.,Independent,4551,1,4552,0.33,S1014
6,POOJA N. ANNAIAH,Independent,3454,3,3457,0.25,S1014
7,A.D. SHIVAPPA,Bahujan Samaj Party,2772,7,2779,0.2,S1014
8,N. V. NAVEEN KUMAR,Independent,1992,1,1993,0.14,S1014
9,ARUNA KANAHALLI,Uttama Prajaakeeya Party,1475,3,1478,0.11,S1014
10,E.H. NAYAK,Independent,953,1,954,0.07,S1014
11,JOHN BENNY,Independent,863,4,867,0.06,S1014
12,GANESH. B (BELLI),Independent,736,11,747,0.05,S1014
13,D.S. ESHWARAPPA,Independent,687,8,695,0.05,S1014
14,KUNAJE MANJUNATHA GOWDA,Independent,671,12,683,0.05,S1014
15,S.K PRABHU,Karnataka Rashtra Samithi,611,6,617,0.04,S1014
16,SHIVARUDRAIAH SWAMY,Independent,599,0,599,0.04,S1014
17,IMTIYAZ A. ATTAR,Independent,440,2,442,0.03,S1014
18,MOHAMMED YUSUF KHAN,Young Star Empowerment Party,403,1,404,0.03,S1014
19,G. JAYADEVA,Independent,367,1,368,0.03,S1014
20,CHANDRASHEKAR. H C,Independent,352,5,357,0.03,S1014
21,P. SRIPATHI. BHAT,Independent,343,1,344,0.02,S1014
22,SANDESH SHETTY. A,Independent,292,1,293,0.02,S1014
23,H SURESH POOJARI,Independent,219,1,220,0.02,S1014
24,NOTA,None of the Above,4311,21,4332,0.31,S1014
1,ARUN KUMAR SAGAR,Bharatiya Janata Party,591500,1218,592718,47.5,S2427
2,JYOTSNA GOND,Samajwadi Party,534720,2619,537339,43.06,S2427
3,DOD RAM VERMA,Bahujan Samaj Party,91302,408,91710,7.35,S2427
4,KIRAN,Rashtriya Sanatan Party,6587,1,6588,0.53,S2427
5,SHIV KUMAR,Independent,2805,0,2805,0.22,S2427
6,MEENA KASYAP,Independent,2051,10,2061,0.17,S2427
7,PRADEEP KUMAR,Independent,1996,9,2005,0.16,S2427
8,PREMCHANDRA HARIJAN,Sardar Patel Siddhant Party,1686,1,1687,0.14,S2427
9,DHARM PAL,Independent,1413,10,1423,0.11,S2427
10,RAMESH CHANDRA VERMA,Manav Kranti Party,1076,0,1076,0.09,S2427
11,NOTA,None of the Above,8449,41,8490,0.68,S2427
1,PRASUN BANERJEE,All India Trinamool Congress,625229,1264,626493,49.26,S2525
2,DR RATHIN CHAKRAVARTY,Bharatiya Janata Party,455996,1055,457051,35.94,S2525
3,SABYASACHI CHATTERJEE,Communist Party of India  (Marxist),151483,522,152005,11.95,S2525
4,PALASH BACHAR,Bahujan Samaj Party,6342,12,6354,0.5,S2525
5,SEIKH SAKIRUL ISLAM,Independent,5271,0,5271,0.41,S2525
6,SHIWA MALLICK,Independent,3218,2,3220,0.25,S2525
7,UTTAM CHATTERJEE,Socialist Unity Centre Of India (COMMUNIST),2319,6,2325,0.18,S2525
8,SHAMPA DAS,Bharatiya Nyay-Adhikar Raksha Party,2053,12,2065,0.16,S2525
9,RATHIN GANGULY,Independent,1884,3,1887,0.15,S2525
10,PRASUN LAHIRI,Independent,1323,3,1326,0.1,S2525
11,RAJESH KUMAR PRASAD,All India Arya Mahasabha,1268,4,1272,0.1,S2525
12,ADARSHA MONDAL,Independent,939,6,945,0.07,S2525
13,AJAZ AHMED ANSARI,Independent,856,1,857,0.07,S2525
14,TAPAS BARUI,Independent,637,4,641,0.05,S2525
15,NOTA,None of the Above,10036,48,10084,0.79,S2525
1,K. SUDHAKARAN,Indian National Congress,512266,6258,518524,48.74,S112
2,M.V. JAYARAJAN,Communist Party of India  (Marxist),402614,6928,409542,38.5,S112
3,C. RAGHUNATH,Bharatiya Janata Party,118352,1524,119876,11.27,S112
4,RAMACHANDRAN BAVILEERI,Bharatheeya Jawan Kisan Party,2606,43,2649,0.25,S112
5,K. SUDHAKARAN S/O. KRISHNAN,Independent,990,19,1009,0.09,S112
6,SUDHAKARAN. K S/O. P GOPALAN,Independent,893,3,896,0.08,S112
7,JOY JOHN PATTAR MADATHIL,Independent,616,2,618,0.06,S112
8,JAYARAJ,Independent,478,10,488,0.05,S112
9,JAYARAJAN S/O. VELAYUDHAN,Independent,421,4,425,0.04,S112
10,VADI HAREENDRAN,Independent,289,54,343,0.03,S112
11,C. BALAKRISHNAN YADAV,Independent,279,25,304,0.03,S112
12,NARAYANA KUMAR,Independent,263,45,308,0.03,S112
13,NOTA,None of the Above,8718,155,8873,0.83,S112
1,DAGGUBATI PURANDHESHWARI,Bharatiya Janata Party,718641,7874,726515,54.82,S018
2,DR. GUDURI SRINIVAS,Yuvajana Sramika Rythu Congress Party,483172,4204,487376,36.77,S018
3,GIDUGU RUDRARAJU,Indian National Congress,31441,1067,32508,2.45,S018
4,GANESWARA RAO PARAMATA,Bahujan Samaj Party,20277,132,20409,1.54,S018
5,BATTULA BALARAMAKRISHNA,Navarang Congress Party,16930,78,17008,1.28,S018
6,SALOPANTULA RAGHAVENDRA RAO,Independent,3261,17,3278,0.25,S018
7,DR. MEDISI RATNARAO ALIAS VINAY,Independent,3109,6,3115,0.24,S018
8,MOHANARAO SINGULURI,Jai Bharat National Party,2818,15,2833,0.21,S018
9,MEDA SRINIVASA RAO,Rashtriya Praja Congress  (Secular),2422,7,2429,0.18,S018
10,BOMMANABOINA VSR MURTHY,Independent,2173,6,2179,0.16,S018
11,BHANU CHANDAR KURUVELLA,Independent,1955,3,1958,0.15,S018
12,JALLI BALA NAVEENA,Independent,1250,4,1254,0.09,S018
13,NOTA,None of the Above,24302,133,24435,1.84,S018
1,V. SOMANNA,Bharatiya Janata Party,716709,4237,720946,55.31,S1019
2,S.P. MUDDAHANUMEGOWDA,Indian National Congress,543064,2288,545352,41.84,S1019
3,J.K. SAMI,Independent,6761,14,6775,0.52,S1019
4,RAJASIMHA J. N.,Bahujan Samaj Party,5521,33,5554,0.43,S1019
5,S.N. SWAMY,Socialist Unity Centre Of India (COMMUNIST),4582,9,4591,0.35,S1019
6,RANGANATHA. R.S,Independent,3129,3,3132,0.24,S1019
7,MALLIKARJUNAIAH,Independent,1872,8,1880,0.14,S1019
8,SIDDARAMEGOWDA T. B,Independent,1644,2,1646,0.13,S1019
9,PRADEEP KUMAR DODDAMUDDEGOWDA,Karnataka Rashtra Samithi,1606,12,1618,0.12,S1019
10,H.L. MOHAN KUMAR,Independent,890,3,893,0.07,S1019
11,PRAKASH. R.A. JAIN,Independent,859,4,863,0.07,S1019
12,NEELAKANTESHA. H S,Independent,710,9,719,0.06,S1019
13,R. PUSHPA,Independent,622,7,629,0.05,S1019
14,B. DEVARAJ,Independent,491,8,499,0.04,S1019
15,R. NARAYANAPPA,Independent,483,24,507,0.04,S1019
16,DR. H.B.M. HIREMATH,Kannada  Paksha,477,0,477,0.04,S1019
17,KAPANIGOWDA.,Independent,451,20,471,0.04,S1019
18,BASAVARAJU. H.R,National Maha Sabha Party,433,6,439,0.03,S1019
19,NOTA,None of the Above,6426,34,6460,0.5,S1019
1,BHASKAR MURLIDHAR BHAGARE,Nationalist Congress Party – Sharadchandra Pawar,575291,2048,577339,46.53,S1320
2,DR. BHARATI PRAVIN PAWAR,Bharatiya Janata Party,462333,1807,464140,37.4,S1320
3,BABU SADU BHAGRE (SIR),Independent,103526,106,103632,8.35,S1320
4,DHOMSE MALATI RAHUL,Vanchit Bahujan  Aaghadi,37006,97,37103,2.99,S1320
5,JAGTAP DIPAK GANPAT,Independent,15664,17,15681,1.26,S1320
6,TULSHIRAM CHIMAN KHOTARE,Bahujan Samaj Party,9589,65,9654,0.78,S1320
7,KISHOR AMBADAS DAGALE,Ambedkarite Party of India,8032,23,8055,0.65,S1320
8,ANIL GAWALIRAM BARDE,Independent,6432,9,6441,0.52,S1320
9,BHARAT ARUN PAWAR,Bahujan Republican  Socialist Party,5613,8,5621,0.45,S1320
10,GULAB MOHAN BARDE,Prabuddha Republican Party,4983,15,4998,0.4,S1320
11,NOTA,None of the Above,8206,40,8246,0.66,S1320
1,RAJIV RANJAN SINGH ALIAS LALAN SINGH,Janata Dal  (United),547814,2332,550146,48.3,S0428
2,KUMARI ANITA,Rashtriya Janata Dal,467412,1864,469276,41.2,S0428
3,SHANKAR PRASAD BIND,Independent,21016,7,21023,1.85,S0428
4,PRIYADARSHI PIYUSH,Independent,15718,13,15731,1.38,S0428
5,A. K. SINGH ‘ASHOK’,Independent,13809,16,13825,1.21,S0428
6,KUMAR NAVNEET HIMANSHU,Bahujan Samaj Party,12143,137,12280,1.08,S0428
7,KULDIP YADAV,Hindustan People's Party (Democratic),9455,31,9486,0.83,S0428
8,NEETISH KUMAR,Independent,7470,37,7507,0.66,S0428
9,PRAVAL KUMAR,Independent,5366,9,5375,0.47,S0428
10,RAVINDRA MANDAL,Socialist Unity Centre Of India (COMMUNIST),4893,20,4913,0.43,S0428
11,ADITYA SINGH MADHUKAR,Independent,4124,16,4140,0.36,S0428
12,PANKAJ KUMAR,Independent,3410,18,3428,0.3,S0428
13,NOTA,None of the Above,21920,31,21951,1.93,S0428
1,BIBHU PRASAD TARAI,Bharatiya Janata Party,585672,3421,589093,45.8,S1816
2,DR. RAJASHREE MALLICK,Biju Janata Dal,546443,1954,548397,42.63,S1816
3,RABINDRA KUMAR SETHY,Indian National Congress,122875,695,123570,9.61,S1816
4,RAMESH CHANDRA SETHY,Communist Party of India,8112,18,8130,0.63,S1816
5,PEEYUUSH DAS,Ambedkarite Party of India,3225,5,3230,0.25,S1816
6,BIBHUTI BHUSAN MAJHI,Bahujan Samaj Party,2718,22,2740,0.21,S1816
7,MAHESWAR DAS,Socialist Unity Centre Of India (COMMUNIST),2374,10,2384,0.19,S1816
8,SANKAR DAS,Independent,1476,12,1488,0.12,S1816
9,SILI MALLICK,Samruddha Odisha,924,6,930,0.07,S1816
10,ARJUNA CHARAN BEHERA,Independent,758,8,766,0.06,S1816
11,BHANUMATI DAS,Utkal Samaj,674,3,677,0.05,S1816
12,NOTA,None of the Above,4852,30,4882,0.38,S1816
1,PUSHPENDRA SAROJ,Samajwadi Party,509175,612,509787,50.51,S2450
2,VINOD KUMAR SONKAR,Bharatiya Janata Party,405142,701,405843,40.21,S2450
3,SHUBH NARAYAN,Bahujan Samaj Party,55797,61,55858,5.53,S2450
4,PUSHPENDRA KUMAR SAROJ,Independent,5178,6,5184,0.51,S2450
5,NARENDRA KUMAR,Apna Dal (Kamerawadi),5127,4,5131,0.51,S2450
6,SANJAY KUMAR,Independent,4631,3,4634,0.46,S2450
7,RAJENDRA SONKAR URF PANNA BHAIYA,Independent,3421,0,3421,0.34,S2450
8,PRADEEP KUMAR,Independent,2539,2,2541,0.25,S2450
9,RAMESHWAR PRASAD,Bhartiya Shakti Chetna Party,2011,2,2013,0.2,S2450
10,RAM ASREY,Manavtawadi Samaj Party,1948,2,1950,0.19,S2450
11,NOTA,None of the Above,12958,9,12967,1.28,S2450
1,LALJI VERMA,Samajwadi Party,543721,1238,544959,46.3,S2455
2,RITESH PANDEY,Bharatiya Janata Party,406851,861,407712,34.64,S2455
3,QAMAR HAYAT,Bahujan Samaj Party,199252,247,199499,16.95,S2455
4,NEELAM SINGH,Moolniwasi Samaj Party,4321,10,4331,0.37,S2455
5,SHABANA KHATOON,Peace Party,3983,7,3990,0.34,S2455
6,JAVED AHMAD SIDDIQUI,Independent,3857,3,3860,0.33,S2455
7,RAM NARESH PRAJAPATI,Bhagidari Party(P),3410,3,3413,0.29,S2455
8,VIVEK KUMAR,Bhartiya Shakti Chetna Party,1848,2,1850,0.16,S2455
9,NOTA,None of the Above,7429,19,7448,0.63,S2455
1,SARMISTHA SETHI,Biju Janata Dal,529428,3224,532652,45.87,S188
2,RABINDRA NARAYAN BEHERA,Bharatiya Janata Party,528959,5280,534239,46.01,S188
3,ANCHAL DAS,Indian National Congress,52455,690,53145,4.58,S188
4,SUBASH CHANDRA MALLIK,Socialist Unity Centre Of India (COMMUNIST),17955,52,18007,1.55,S188
5,ER. SANDHYA RANI MALLICK,Bahujan Samaj Party,3189,29,3218,0.28,S188
6,BHAIRABA PRASAD BEHERA,Independent,2398,5,2403,0.21,S188
7,SUMANTA MALIK,Independent,2295,6,2301,0.2,S188
8,BIDYADHAR DALEI,Ambedkarite Party of India,2172,0,2172,0.19,S188
9,JHUNA MALIK,Manas Lokshakti Dal,2075,2,2077,0.18,S188
10,ARTTATRANA MALIK,Independent,1234,18,1252,0.11,S188
11,NARENDRA MALIKA,Independent,1119,0,1119,0.1,S188
12,MANTU SETHI,Janta Darbar Party,954,2,956,0.08,S188
13,BINOD KUMAR JENA,Gana Suraksha Party,876,3,879,0.08,S188
14,NOTA,None of the Above,6738,50,6788,0.58,S188
1,NEERAJ MAURYA,Samajwadi Party,491119,1396,492515,45.23,S2424
2,DHARMENDRA KASHYAP,Bharatiya Janata Party,475434,1112,476546,43.76,S2424
3,ABID ALI,Bahujan Samaj Party,95407,223,95630,8.78,S2424
4,KAUSAR KHAN,Peace Party,4210,3,4213,0.39,S2424
5,PREM PAL SAGAR,Vanchitsamaj Insaaf Party,3328,2,3330,0.31,S2424
6,MAKKHAN LAL,Independent,2946,7,2953,0.27,S2424
7,RAJ KUMAR PATEL,Sardar Patel Siddhant Party,2700,6,2706,0.25,S2424
8,MOHAMMAD AMIR KHAN,Bharat Jodo Party,2348,7,2355,0.22,S2424
9,NIRMOD KUMAR SINGH,Bhartiya Shakti Chetna Party,1785,5,1790,0.16,S2424
10,NOTA,None of the Above,6843,15,6858,0.63,S2424
1,ADHIKARI SOUMENDU,Bharatiya Janata Party,757906,5289,763195,49.85,S2531
2,UTTAM BARIK SON OF LATE BIRENDRA BARIK,All India Trinamool Congress,709763,5668,715431,46.73,S2531
3,URBASI BANERJEE,Indian National Congress,30737,385,31122,2.03,S2531
4,BIDESH BASU MAITY,Independent,5633,21,5654,0.37,S2531
5,MANAS PRADHAN,Socialist Unity Centre Of India (COMMUNIST),2489,40,2529,0.17,S2531
6,UTTAM BARIK SON OF LATE NARAYAN BARIK,Independent,1963,35,1998,0.13,S2531
7,MAKHAN LAL MAHAPATRA,Bahujan Samaj Party,1792,12,1804,0.12,S2531
8,MD AHAMADULLAH KHAN,Independent,530,56,586,0.04,S2531
9,ARJUN KUMAR MAITY,Independent,504,40,544,0.04,S2531
10,NOTA,None of the Above,8075,59,8134,0.53,S2531
1,Suresh Kumar Kashyap,Bharatiya Janata Party,513936,5812,519748,53.58,S084
2,Vinod Sultanpuri,Indian National Congress,423388,4909,428297,44.16,S084
3,Anil Kumar Manget,Bahujan Samaj Party,6379,121,6500,0.67,S084
4,Suresh Kumar,Rashtriya Devbhumi Party,4766,48,4814,0.5,S084
5,Madan Lal,Akhil Bhartiya Parivar Party,4633,43,4676,0.48,S084
6,NOTA,None of the Above,5876,54,5930,0.61,S084
1,JAI PARKASH (J P) S/O HARIKESH,Indian National Congress,567194,3230,570424,48.58,S074
2,RANJIT SINGH,Bharatiya Janata Party,504944,2099,507043,43.19,S074
3,DESH RAJ,Bahujan Samaj Party,25892,123,26015,2.22,S074
4,SUNAINA CHAUTALA,Indian National Lok Dal,22171,132,22303,1.9,S074
5,NAINA SINGH CHAUTALA,Jannayak Janta Party,21910,122,22032,1.88,S074
6,PARDEEP DAHIYA,Independent,3607,1,3608,0.31,S074
7,JAI PRAKASH (J.P.) S/O UMA DUTT,Independent,3267,6,3273,0.28,S074
8,JILE SINGH,Independent,3196,0,3196,0.27,S074
9,POONAM MOR,Independent,1237,4,1241,0.11,S074
10,ISHWAR JHAJHRIA,Independent,1121,1,1122,0.1,S074
11,ATMA RAM BISHNOI,Independent,1091,6,1097,0.09,S074
12,KULBIR,Independent,1041,0,1041,0.09,S074
13,CHANDER MOHAN,Independent,995,3,998,0.09,S074
14,ADVOCATE PARDEEP SIHMAR,Peoples Party of India (Democratic),871,5,876,0.07,S074
15,AJIT SINGH,Independent,794,2,796,0.07,S074
16,DEV GIRI,Rashtriya Lokswaraj Party,719,7,726,0.06,S074
17,DINESH KUMAR,Independent,699,4,703,0.06,S074
18,MASTER VIJENDER JITPURA,Socialist Unity Centre Of India (COMMUNIST),654,3,657,0.06,S074
19,RAJENDER KUMAR,Independent,485,1,486,0.04,S074
20,NEERAJ KUMAR “CHHATTAR”,Bharatiya Asha Party,419,4,423,0.04,S074
21,MANDEEP,Independent,404,1,405,0.03,S074
22,JAGAT SINGH,Vikas India Party,374,8,382,0.03,S074
23,PARJAPATI RAKESH DHUWARIA,Independent,372,2,374,0.03,S074
24,RANDHIR SINGH,Independent,352,1,353,0.03,S074
25,SURENDER KUMAR,Independent,326,0,326,0.03,S074
26,SURENDER,Independent,308,0,308,0.03,S074
27,VIJAY SINGH,Independent,270,2,272,0.02,S074
28,YOGESH BOORA,Independent,267,2,269,0.02,S074
29,NOTA,None of the Above,3333,33,3366,0.29,S074
1,HARIBHAI PATEL,Bharatiya Janata Party,675614,10792,686406,63.74,S064
2,RAMJI THAKOR,Indian National Congress,352578,5782,358360,33.28,S064
3,AMRUTLAL MAKWANA,Bahujan Samaj Party,9710,164,9874,0.92,S064
4,CHAUHAN PRAKASHKUMAR TRIBHOVANDAS,Akhila Vijaya Party,3866,16,3882,0.36,S064
5,PATEL MANUBHAI SHANKARLAL,Independent,3597,75,3672,0.34,S064
6,ZALA VIKRAMSINH BANESINH,Rashtra Nirman Party,2949,58,3007,0.28,S064
7,NOTA,None of the Above,11002,624,11626,1.08,S064
1,CHAVDA VINOD LAKHAMSHI,Bharatiya Janata Party,656979,2595,659574,60.23,S061
2,NITESH PARBATBHAI LALAN (MATANG),Indian National Congress,389384,1408,390792,35.68,S061
3,VIJAY BHACHRA,Bahujan Samaj Party,6075,36,6111,0.56,S061
4,VANAZARA HIRABEN DALPATBHAI,Independent,5145,6,5151,0.47,S061
5,BABULAL LADHA CHAVDA,Independent,3348,6,3354,0.31,S061
6,KAVITABEN DINESHBHAI MACHCHHOYA,Independent,3342,24,3366,0.31,S061
7,DEVABHAI MITHABHAI GOHIL,Rashtriya Power Party,2087,14,2101,0.19,S061
8,SHAMLIA VIRJI CHAKU,Hindvi Swarajyay Dal,1560,13,1573,0.14,S061
9,ARVIND ASHOK SANGHELA,Gujarat Sarva Samaj Party,1509,17,1526,0.14,S061
10,BOCHIYA BHIMJI BHIKHA,Sarva Samaj Janata Party,1491,6,1497,0.14,S061
11,RAMJIBHAI JAKHUBHAI DAFDA,Right to Recall Party,1357,13,1370,0.13,S061
12,NOTA,None of the Above,18604,138,18742,1.71,S061
1,SHASHI THAROOR,Indian National Congress,353679,4476,358155,37.19,S1120
2,RAJEEV CHANDRASEKHAR,Bharatiya Janata Party,337920,4158,342078,35.52,S1120
3,PANNIAN RAVINDRAN,Communist Party of India,244433,3215,247648,25.72,S1120
4,ADV RAJENDRAN,Bahujan Samaj Party,2315,37,2352,0.24,S1120
5,ADV SHINE LAL M P,Independent,1446,37,1483,0.15,S1120
6,J J RUSSELL,Independent,1348,17,1365,0.14,S1120
7,S MINI,Socialist Unity Centre Of India (COMMUNIST),1098,11,1109,0.12,S1120
8,M S SUBI,Independent,588,11,599,0.06,S1120
9,CHALAI MOHANAN,Independent,396,4,400,0.04,S1120
10,NANDAVANAM SUSEELAN,Independent,391,29,420,0.04,S1120
11,SHAJU PALIYODU,Independent,348,40,388,0.04,S1120
12,SASI KONGAPALLY,Independent,228,5,233,0.02,S1120
13,NOTA,None of the Above,6684,69,6753,0.7,S1120
1,DR. ALOK KUMAR SUMAN,Janata Dal  (United),510329,1537,511866,48.15,S0417
2,PREM NATH CHANCHAL ALIAS CHANCHAL PASWAN,Vikassheel Insaan Party,383065,1621,384686,36.19,S0417
3,DINANATH MANJHI,All India Majlis-E-Ittehadul Muslimeen,29900,92,29992,2.82,S0417
4,SUJEET KUMAR RAM,Bahujan Samaj Party,29145,127,29272,2.75,S0417
5,ANIL RAM,Independent,12988,14,13002,1.22,S0417
6,SATYENDRA BAITHA,Independent,12253,16,12269,1.15,S0417
7,BHOLA HARIJAN,Independent,11138,2,11140,1.05,S0417
8,RAM KUMAR MANJHI,Gana Suraksha Party,8531,9,8540,0.8,S0417
9,NAMI RAM,Independent,6716,0,6716,0.63,S0417
10,SURENDRA RAM,Bhartiya Rashtriya Dal,6673,39,6712,0.63,S0417
11,JITENDRA RAM,Bahujan Mukti Party,5942,27,5969,0.56,S0417
12,NOTA,None of the Above,42713,150,42863,4.03,S0417
1,HARSH MALHOTRA,Bharatiya Janata Party,663420,1399,664819,52.59,U053
2,KULDEEP KUMAR (MONU),Aam Aadmi Party,570494,662,571156,45.18,U053
3,MOHD. WAQAR CHOUDHARY,Bahujan Samaj Party,9158,39,9197,0.73,U053
4,A. GOPALA KRISHNA,Navarang Congress Party,2807,10,2817,0.22,U053
5,KULDEEP KUMAR,Independent,1579,3,1582,0.13,U053
6,MANOJ KUMAR GUPTA (SWARAJI),Independent,1191,1,1192,0.09,U053
7,RODASH GUPTA,Independent,1097,2,1099,0.09,U053
8,JYOTI PRAKASH (MONU),Ekam Sanatan Bharat Dal,824,0,824,0.07,U053
9,ARUNIMA GAUTAM,Independent,749,2,751,0.06,U053
10,JAI RAM LAL,Rashtriya Republican Party,657,0,657,0.05,U053
11,ADVOCATE MANJEET SINGH,Rashtra Nirman Party,614,0,614,0.05,U053
12,MOHAMMAD IRFAN,Independent,582,1,583,0.05,U053
13,OM SHANKAR,Independent,556,0,556,0.04,U053
14,LAL SINGH,Bahujan Dravida Party,476,1,477,0.04,U053
15,YOGESH CHAUDHARY,Bhartiya Veer Dal,468,2,470,0.04,U053
16,VIMAL KUMAR SAXENA,Independent,427,6,433,0.03,U053
17,SURENDRA SINGH BASOYA,Peoples Party of India (Democratic),392,7,399,0.03,U053
18,SANJAY,Public Political Party,378,1,379,0.03,U053
19,AMIT GUPTA,Independent,358,2,360,0.03,U053
20,SANJAYA KUMAR YADAV,Right to Recall Party,289,1,290,0.02,U053
21,NOTA,None of the Above,5371,23,5394,0.43,U053
1,BISHNU PADA RAY,Bharatiya Janata Party,102182,254,102436,50.58,U011
2,KULDEEP RAI SHARMA,Indian National Congress,77829,211,78040,38.54,U011
3,MANOJ PAUL,Andaman Nicobar Democratic Congress,8236,18,8254,4.08,U011
4,D AYYAPPAN,Communist Party of India  (Marxist),6009,8,6017,2.97,U011
5,V.K. ABDUL AZIZ,Independent,2195,8,2203,1.09,U011
6,K J B SELVARAJ,All India Anna Dravida Munnetra Kazhagam,911,3,914,0.45,U011
7,DR ARUN KUMAR MALLIK,Bahujan Samaj Party,714,5,719,0.36,U011
8,RINKU MALA MONDAL,Independent,539,3,542,0.27,U011
9,K VENKAT RAM BABU,Independent,506,1,507,0.25,U011
10,USHA KUMARI,Independent,378,2,380,0.19,U011
11,SALAMAT MONDAL,Socialist Unity Centre Of India (COMMUNIST),349,2,351,0.17,U011
12,ANAND RAMNATH ARLEKAR,Independent,342,0,342,0.17,U011
13,NOTA,None of the Above,1802,7,1809,0.89,U011
1,RADHAKRISHNA,Indian National Congress,650623,1698,652321,49.78,S105
2,DR. UMESH G JADHAV,Bharatiya Janata Party,622615,2501,625116,47.7,S105
3,HUCHESHWARA WATHAR GOUR,Bahujan Samaj Party,7871,17,7888,0.6,S105
4,SUNDAR,Independent,3675,2,3677,0.28,S105
5,JYOTI RAMESH CHAVAN,Independent,2787,18,2805,0.21,S105
6,SHARANAPPA (PINTU),Independent,1879,5,1884,0.14,S105
7,TARABAI BHOVI,Independent,1546,4,1550,0.12,S105
8,RAMESH BHIMSING CHAVAN,Independent,1332,2,1334,0.1,S105
9,ANAND SINNUR,Independent,1271,9,1280,0.1,S105
10,NAGENDRA RAO,Uttama Prajaakeeya Party,1211,15,1226,0.09,S105
11,S.M.SHARMA,Socialist Unity Centre Of India (COMMUNIST),1136,8,1144,0.09,S105
12,RAJKUMAR,BhartiyaBahujanKranti Dal,702,7,709,0.05,S105
13,VIJAY JADHAV,Karnataka Rashtra Samithi,555,5,560,0.04,S105
14,B. VIJAYKUMAR CHINCHANSOORKAR,Prahar Janshakti Party,548,6,554,0.04,S105
15,NOTA,None of the Above,8416,13,8429,0.64,S105
1,CHHATRA PAL SINGH GANGWAR,Bharatiya Janata Party,565600,1527,567127,50.66,S2425
2,PRAVEEN SINGH ARON,Samajwadi Party,530825,1498,532323,47.55,S2425
3,IRSHAD ANSARI ADVOCATE,Peace Party,3548,5,3553,0.32,S2425
4,WASEEM MIAN,Independent,2839,0,2839,0.25,S2425
5,BHUPENDRA KUMAR MAURYA,Peoples Party of India (Democratic),1702,2,1704,0.15,S2425
6,BUDDH PRIYA KARMRAJ RAHUL,Independent,1192,2,1194,0.11,S2425
7,ROHTASH KASHYAP,Jan Shakti Ekta Party,844,3,847,0.08,S2425
8,JAGPAL SINGH YADAV,Samrat Mihir Bhoj Samaj Party,654,2,656,0.06,S2425
9,RAVI KUMAR,Sardar Patel Siddhant Party,626,1,627,0.06,S2425
10,MOHD NAJIM ALI,Bharat Jodo Party,624,9,633,0.06,S2425
11,NITIN MOHAN,Independent,619,1,620,0.06,S2425
12,ASHISH GANGWAR,Independent,616,0,616,0.06,S2425
13,AYSHA BI,Independent,550,9,559,0.05,S2425
14,NOTA,None of the Above,6226,34,6260,0.56,S2425
1,MANOJ TIWARI,Bharatiya Janata Party,821567,2884,824451,53.1,U052
2,KANHAIYA KUMAR,Indian National Congress,684501,1172,685673,44.16,U052
3,ASHOK KUMAR,Bahujan Samaj Party,12053,85,12138,0.78,U052
4,SUNITA,Navarang Congress Party,3518,0,3518,0.23,U052
5,AKESHAN DUT,Independent,3325,0,3325,0.21,U052
6,SUSHIL CHOUDHARY,Aapki Apni Party (Peoples),2066,4,2070,0.13,U052
7,AJAY TIWARI,Right to Recall Party,2040,2,2042,0.13,U052
8,SUBHASH,Rashtriya Janmorcha,1639,0,1639,0.11,U052
9,AKASH SRIVASTAV,Jai Hind National Party,1317,0,1317,0.08,U052
10,SANJEEV KUMAR PANDEY,Bharatiya Liberal Party,1163,0,1163,0.07,U052
11,SAROJ KUMAR RAY,Independent,931,66,997,0.06,U052
12,ADV. BHIM KISHOR,Peoples Party of India (Democratic),826,1,827,0.05,U052
13,SANJEEV KUMAR,Public Political Party,799,0,799,0.05,U052
14,PRAKASH DEVI,Socialist Unity Centre Of India (COMMUNIST),676,0,676,0.04,U052
15,LAKSHYA VASHIST (SHYAM),Jindabad Kranti Party,653,0,653,0.04,U052
16,BABITA YADAV,Aazad Samaj Party (Kanshi Ram),646,0,646,0.04,U052
17,MANOJ KUMAR,Independent,559,2,561,0.04,U052
18,NIVEDITA SHARMA “PREM”,Rashtrawadi Janlok Party (Satya),541,2,543,0.03,U052
19,DR. RAJESH KUMAR SINGH,Independent,539,1,540,0.03,U052
20,KANHI LAL,Swatantra Jantaraj Party,496,2,498,0.03,U052
21,VIJAY KUMAR JHA,Independent,486,5,491,0.03,U052
22,YOGESH SWAMY,Independent,410,0,410,0.03,U052
23,ASHOK MISHRA,Independent,352,0,352,0.02,U052
24,ADV. K.T. PALUSKAR,Prabuddha Republican Party,349,0,349,0.02,U052
25,RAVI KIRAN THILAK THATIKONDA,Independent,324,0,324,0.02,U052
26,ISHWAR CHAND,Bharatrashtra Democratic Party,310,0,310,0.02,U052
27,JAGDISH,Rashtriya Samaj Paksha,276,0,276,0.02,U052
28,BIRPAL SINGH KOLI,Independent,269,1,270,0.02,U052
29,NOTA,None of the Above,5845,28,5873,0.38,U052
1,ASHOK KUMAR RAWAT,Bharatiya Janata Party,473971,1045,475016,45.15,S2432
2,SANGITA RAJVANSHI,Samajwadi Party,440157,1453,441610,41.98,S2432
3,B R AHIRWAR,Bahujan Samaj Party,111670,275,111945,10.64,S2432
4,RAMPAL,Independent,3973,5,3978,0.38,S2432
5,LALIT KUMAR,Bhartiya Shakti Chetna Party,3811,4,3815,0.36,S2432
6,Neelam Singh,Independent,2899,6,2905,0.28,S2432
7,VANDNA  VERMA,Naari Nar Rakshak Party,1907,5,1912,0.18,S2432
8,AVDHESH,Independent,1419,4,1423,0.14,S2432
9,SAVITRI DEVI,Rashtriya Janshakti Samaj Party,1347,3,1350,0.13,S2432
10,NOTA,None of the Above,7997,32,8029,0.76,S2432
1,RICHARD VANLALHMANGAIHA,Zoram People’s Movement,206377,2175,208552,42.45,S161
2,K VANLALVENA,Mizo National Front,139532,732,140264,28.55,S161
3,LALBIAKZAMA,Indian National Congress,97761,834,98595,20.07,S161
4,VANLALHMUAKA,Bharatiya Janata Party,33009,524,33533,6.82,S161
5,LALHRIATRENGA CHHANGTE,Independent,4663,43,4706,0.96,S161
6,RITA MALSAWMI,Mizoram People's Conference,3681,112,3793,0.77,S161
7,NOTA,None of the Above,1866,27,1893,0.39,S161
1,KAMLESH JANGDE,Bharatiya Janata Party,675740,2459,678199,48.71,S263
2,DR. SHIVKUMAR DAHARIYA,Indian National Congress,616131,2068,618199,44.4,S263
3,DR. ROHIT DAHARIA,Bahujan Samaj Party,48089,412,48501,3.48,S263
4,ENGINEER REVA KURREY,Independent,8158,1,8159,0.59,S263
5,AD. T.R. NIRALA,Independent,5792,2,5794,0.42,S263
6,ANIL MANHAR,Hamar Raj Party,5770,10,5780,0.42,S263
7,VIDYA DEVI SONI,Independent,4877,4,4881,0.35,S263
8,MINA CHAUHAN,Independent,2929,2,2931,0.21,S263
9,ANAND GILHARE,Independent,2876,1,2877,0.21,S263
10,DEEPAK KUMAR KHUNTE,Aazad Samaj Party (Kanshi Ram),1822,7,1829,0.13,S263
11,ARVIND KUMAR,Independent,1710,5,1715,0.12,S263
12,GOPAL PRASAD KHUNTE,Bhartiya Shakti Chetna Party,1471,12,1483,0.11,S263
13,VIJAYLAXMI SURYAWANSHI NAT,Asankhya Samaj Party,1417,5,1422,0.1,S263
14,SIMA MAHILANGE,Independent,1333,3,1336,0.1,S263
15,ADVOCATE SHAILENDRA BANJARE (SHAKTIPUTRA),Shakti Sena (Bharat Desh),1248,5,1253,0.09,S263
16,VIJAY KUMAR KURRE,Rashtriya Jansabha Party,981,2,983,0.07,S263
17,BRINDA CHAUHAN,Chhattisgarh Vikas Ganga Rashtriya Party,921,3,924,0.07,S263
18,JAGJIVAN RAM SATNAMI,Azad Janata Party,833,4,837,0.06,S263
19,NOTA,None of the Above,5098,39,5137,0.37,S263
1,RAJU BISTA,Bharatiya Janata Party,675324,4007,679331,51.18,S254
2,GOPAL LAMA,All India Trinamool Congress,498789,2017,500806,37.73,S254
3,MUNISH TAMANG,Indian National Congress,82597,777,83374,6.28,S254
4,BANDANA RAI,Independent,13155,519,13674,1.03,S254
5,BISHNU PRASAD SHARMA,Independent,7431,16,7447,0.56,S254
6,BHUPENDRA LEPCHA,Independent,6369,26,6395,0.48,S254
7,ATASI BISWAS,Kisan Mazdoor Sangharsh Party,4586,55,4641,0.35,S254
8,PRADHAN MARDI,Ambedkarite Party of India,2714,33,2747,0.21,S254
9,KHUSHI RANJAN MANDAL,Independent,2313,24,2337,0.18,S254
10,KALICHARAN BARMAN,Independent,2055,24,2079,0.16,S254
11,QAMRUL HAQUE,North Bengal People’s Party,1829,24,1853,0.14,S254
12,BUDHARU ROY,Kamatapur People’s Party (United),1734,28,1762,0.13,S254
13,SHAHRIAR ALAM,Socialist Unity Centre Of India (COMMUNIST),1605,9,1614,0.12,S254
14,SUBODH PAKHRIN,Gorkha Rashtriya Congress,1270,61,1331,0.1,S254
15,NOTA,None of the Above,17960,61,18021,1.36,S254
1,G M HARISH (BALAYOGI),Telugu Desam,786149,10832,796981,61.25,S017
2,RAPAKA VARAPRASADA RAO,Yuvajana Sramika Rythu Congress Party,450362,4423,454785,34.95,S017
3,GOUTHAM JANGA,Indian National Congress,14523,559,15082,1.16,S017
4,DORABABU YALLA,Bahujan Samaj Party,5202,186,5388,0.41,S017
5,KATRU NAGA BABU,Telugu Nava Garjana Party,3736,5,3741,0.29,S017
6,VADDI LALITH KUMAR,Independent,2974,3,2977,0.23,S017
7,MAKEY DAVY PRASAD,Independent,2104,7,2111,0.16,S017
8,GUDE VENKATESWARULU,Independent,1741,4,1745,0.13,S017
9,RAMESH JILLELLA,Jatiya Jana Sena Party,866,6,872,0.07,S017
10,YALANGI RAMESH,Jaibhim Rao Bharat Party,738,2,740,0.06,S017
11,MATHA KRISHNA,Pyramid Party of India,718,1,719,0.06,S017
12,GIDDI JNANA PRAKASA RAO,Republican Party of India,717,9,726,0.06,S017
13,YADLA RAJESH,Liberation Congress Party,628,7,635,0.05,S017
14,KAPA KALYAN,Republican Party of India (A),579,2,581,0.04,S017
15,PATHURI RAMESH,Peoples Party of India (Democratic),502,3,505,0.04,S017
16,NOTA,None of the Above,13418,100,13518,1.04,S017
1,TANUJ PUNIA,Indian National Congress,718528,1399,719927,55.78,S2453
2,RAJRANI RAWAT,Bharatiya Janata Party,503452,771,504223,39.07,S2453
3,SHIV KUMAR DOHAREY,Bahujan Samaj Party,39105,72,39177,3.04,S2453
4,BABOORAM,Independent,3669,0,3669,0.28,S2453
5,RAMLAKHAN PASI,Independent,2927,1,2928,0.23,S2453
6,MITHALESH KUMARI,Independent,2320,1,2321,0.18,S2453
7,DEVATADEEN GAUTAM,Independent,2172,1,2173,0.17,S2453
8,ASHA DEVI,Swatantrata Abhivyakti Party,2018,2,2020,0.16,S2453
9,PROF. (DR.) RAM GHULAM RAZDAN,Public Adhikar Socialist Indian Party,1493,0,1493,0.12,S2453
10,MAHENDRA KUMAR RAWAT,Awami Samta Party,1189,1,1190,0.09,S2453
11,OMKAR,Independent,1137,1,1138,0.09,S2453
12,ADVOCATE SANTOSH RAWAT,Dr. Bhimrao Ambedkar Dal,1076,2,1078,0.08,S2453
13,PREMCHANDRA HARIJAN,Sardar Patel Siddhant Party,1075,1,1076,0.08,S2453
14,NOTA,None of the Above,8220,1,8221,0.64,S2453
1,RAHUL KASWAN,Indian National Congress,719352,8859,728211,51.12,S203
2,DEVENDRA JHAJHARIA,Bharatiya Janata Party,647891,7583,655474,46.01,S203
3,DEIRAM MEGHWAL,Bahujan Samaj Party,11145,126,11271,0.79,S203
4,RAMESH KUMAR,Independent,5720,4,5724,0.4,S203
5,GOMATI DHARAMPAL KATARIA,Bharat Rakshak Party (Democratic),4937,24,4961,0.35,S203
6,SUKHDEV,Independent,4550,9,4559,0.32,S203
7,RANVEER SINGH,Independent,1809,3,1812,0.13,S203
8,BISAN SINGH,Independent,1571,73,1644,0.12,S203
9,DAULAT RAM PENSIA,National Janmandal Party,1178,15,1193,0.08,S203
10,YUSUF ALI KHAN,Independent,1176,54,1230,0.09,S203
11,SHISHPAL SINGH RANA,Bheem Tribal Congress,671,4,675,0.05,S203
12,NIRANJAN SINGH RATHORE,Independent,648,20,668,0.05,S203
13,ASLAM LILGAR,Independent,558,9,567,0.04,S203
14,NOTA,None of the Above,6583,73,6656,0.47,S203
1,AMRINDER SINGH RAJA WARRING,Indian National Congress,321424,800,322224,30.42,S197
2,RAVNEET SINGH BITTU,Bharatiya Janata Party,300927,355,301282,28.45,S197
3,ASHOK PRASHAR PAPPI,Aam Aadmi Party,236620,457,237077,22.38,S197
4,RANJIT SINGH DHILLON,Shiromani Akali Dal,90073,147,90220,8.52,S197
5,KAMALJIT SINGH BRAR,Independent,42462,38,42500,4.01,S197
6,AMRITPAL SINGH CHHANDRAN,Shiromani Akali Dal (Amritsar)(Simranjit Singh Mann),18199,42,18241,1.72,S197
7,DAVINDER SINGH RAMGARHIA,Bahujan Samaj Party,10365,29,10394,0.98,S197
8,NARESH DHINGAAN,Independent,2524,6,2530,0.24,S197
9,RAKESH KUMAR (RICKY),Sunahara Bharat Party,2091,0,2091,0.2,S197
10,ER. BALDEV RAJ KATNA (DEBI),Independent,2086,0,2086,0.2,S197
11,PRITPAL SINGH,Bahujan Dravida Party,1821,3,1824,0.17,S197
12,DR. PALWINDER KAUR,Independent,1766,2,1768,0.17,S197
13,SANJEEV KUMAR (SANJU),Independent,1567,0,1567,0.15,S197
14,RAJIV KUMAR MEHRA,Jan Sewa Driver Party,1516,2,1518,0.14,S197
15,BHUPINDER SINGH,Bharatheeya Jawan Kisan Party,1287,0,1287,0.12,S197
16,BALJIT SINGH,Independent,1137,1,1138,0.11,S197
17,VIPAN KUMAR BATRA,Independent,1041,0,1041,0.1,S197
18,AMANDEEP SINGH,Sehajdhari Sikh Party,981,6,987,0.09,S197
19,PARAMJIT SINGH,Independent,927,0,927,0.09,S197
20,BALVINDER SINGH BITTA,Independent,918,0,918,0.09,S197
21,SIMRANDEEP SINGH,Independent,911,1,912,0.09,S197
22,DEVINDER BHAGRIA,Hindustan Shakti Sena,859,1,860,0.08,S197
23,KANIYA LAL (DR. KISHAN KUMAR),Independent,820,0,820,0.08,S197
24,SUDHIR KUMAR TRIPATHI,Independent,770,0,770,0.07,S197
25,GURDEEP SINGH KAHLON,Independent,738,0,738,0.07,S197
26,DR. DEVINDER SINGH GILL,Aam Lok Party United,693,2,695,0.07,S197
27,KIRPAL SINGH KAPURI,Independent,621,0,621,0.06,S197
28,SANTOSH KUMAR,Bharatiya Inqalab Party,610,0,610,0.06,S197
29,KAMAL PAWAR,Independent,592,0,592,0.06,S197
30,RAVINDER PAL SINGH BABA JI BARGAR WALE,Independent,546,2,548,0.05,S197
31,GURMEET SINGH KHARAY,Independent,516,1,517,0.05,S197
32,RUPINDER KUMAR,Independent,467,0,467,0.04,S197
33,CHANDI,Independent,456,0,456,0.04,S197
34,BALDEV SINGH SUMAN,Independent,450,0,450,0.04,S197
35,JAI - PARKASH JAIN (TITU BANIYA),Independent,419,0,419,0.04,S197
36,SHIVAM YADAV,Global Republican Party,414,1,415,0.04,S197
37,HARVINDER KAUR,Samajik Sangharsh Party,413,6,419,0.04,S197
38,BHOLA SINGH,Independent,411,0,411,0.04,S197
39,DARSHAN SINGH DABA,Nationalist Justice Party,390,0,390,0.04,S197
40,KULDEEP KUMAR SHARMA,Independent,383,0,383,0.04,S197
41,VISHAL KUMAR ARORA,Independent,344,0,344,0.03,S197
42,KARNAIL SINGH,Independent,340,0,340,0.03,S197
43,RAJINDER GHAI,Independent,284,0,284,0.03,S197
44,NOTA,None of the Above,5040,36,5076,0.48,S197
1,RADHA MOHAN SINGH,Bharatiya Janata Party,540598,1595,542193,50.5,S043
2,DR RAJESH KUMAR,Vikassheel Insaan Party,451118,2788,453906,42.28,S043
3,MOHAMMAD AJMER ALAM,Independent,13030,17,13047,1.22,S043
4,VIJAY KUMAR SAHANI,Rashtriya Jansambhavna Party,8158,27,8185,0.76,S043
5,RAJESH SINGH,Independent,7176,6,7182,0.67,S043
6,GYANTI DEVI,Prabuddha Republican Party,6963,45,7008,0.65,S043
7,PAWAN KUMAR,Bhartiya Sarthak Party,4895,19,4914,0.46,S043
8,MUNESHWAR TIWARI,Independent,4017,5,4022,0.37,S043
9,RAJESH KUMAR S/O GAGANLAL SAHNI,Independent,3930,4,3934,0.37,S043
10,RAJESH KUMAR S/O VISHUN SAH,Independent,3489,3,3492,0.33,S043
11,NAWAL KISHOR PRASAD,Viro Ke Vir Indian Party,3449,15,3464,0.32,S043
12,NIKESH KUMAR,Independent,2539,14,2553,0.24,S043
13,NOTA,None of the Above,19729,59,19788,1.84,S043
1,JANARDAN MISHRA,Bharatiya Janata Party,475439,2020,477459,52,S1210
2,NEELAM ABHAY MISHRA,Indian National Congress,283187,898,284085,30.94,S1210
3,ADV. ABHISHEK MASTER BUDDHSEN PATEL,Bahujan Samaj Party,117089,132,117221,12.77,S1210
4,DAYASHANKAR PANDEY,Independent,4609,1,4610,0.5,S1210
5,ROSHAN LAL KOL,Independent,4110,12,4122,0.45,S1210
6,ER. DEVENDRA SINGH,Sapaks Party,4065,11,4076,0.44,S1210
7,ER. RAM KUMAR SONI,Independent,3868,5,3873,0.42,S1210
8,RAM GOPAL SINGH,Peoples Party of India (Democratic),3502,7,3509,0.38,S1210
9,PRASSAN JEET SINGH,Independent,3306,7,3313,0.36,S1210
10,JANARDAN MISHRA,Independent,2274,21,2295,0.25,S1210
11,RANJAN GUPTA,Rashtravadi Bharat Party,2151,9,2160,0.24,S1210
12,VIPIN SINGH PATEL,Rashtriya Hind Ekta Dal,1799,7,1806,0.2,S1210
13,ARUNENDRA NARAYAN PANDEY,Independent,1550,1,1551,0.17,S1210
14,ARUN TIWARI 'MINTU',Independent,1113,0,1113,0.12,S1210
15,NOTA,None of the Above,6916,20,6936,0.76,S1210
1,MANSUKHBHAI DHANJIBHAI VASAVA,Bharatiya Janata Party,605489,2668,608157,50.72,S0622
2,CHAITARBHAI DAMJIBHAI VASAVA,Aam Aadmi Party,518419,4042,522461,43.58,S0622
3,DILIPBHAI CHHOTUBHAI VASAVA,Bharat Adivasi Party,9981,33,10014,0.84,S0622
4,SAJID YAKUB MUNSHI,Independent,9934,3,9937,0.83,S0622
5,VASAVA CHETANBHAI KANJIBHAI,Bahujan Samaj Party,6312,12,6324,0.53,S0622
6,NAVINBHAI BHIKHABHAI PATEL,Independent,3440,13,3453,0.29,S0622
7,YUSUF VALI HASANALI,Independent,3245,2,3247,0.27,S0622
8,GITABEN MANUBHAI MACHHI,Malwa Congress,2750,14,2764,0.23,S0622
9,MITESHBHAI THAKORBHAI PADHIYAR,Independent,2451,8,2459,0.21,S0622
10,MIRZA AABIDBEG YASINBEG,Independent,2043,7,2050,0.17,S0622
11,ISMAIL AHMAD PATEL,Independent,1887,15,1902,0.16,S0622
12,NARAYANBHAI LILADHARJI RAVAL,Independent,1574,9,1583,0.13,S0622
13,DHARMESHKUMAR VISHNUBHAI VASAVA,Independent,1324,6,1330,0.11,S0622
14,NOTA,None of the Above,23151,132,23283,1.94,S0622
1,TANGELLA UDAY SRINIVAS  (TEA TIME UDAY),Janasena Party,718971,10728,729699,54.87,S016
2,CHALAMALASETTY SUNIL,Yuvajana Sramika Rythu Congress Party,495188,5020,500208,37.62,S016
3,MALLIPUDI MANGAPATI PALLAM RAJU,Indian National Congress,20258,851,21109,1.59,S016
4,UDAY,Navarang Congress Party,15578,125,15703,1.18,S016
5,KANDREGULA NARASIMHAM,Bahujan Samaj Party,11916,63,11979,0.9,S016
6,DR ANUSHA YADAV,Bharatha Chaitanya Yuvajana Party,9818,36,9854,0.74,S016
7,TANGELLA SRINIVASU,Jatiya Jana Sena Party,6516,43,6559,0.49,S016
8,YEDIDA VARA PRASAD KUMAR,Republican Party of India (A),3924,3,3927,0.3,S016
9,BUGATHA BANGARRAO,Communist Party of India  (Marxist-Leninist)  (Liberation),2816,7,2823,0.21,S016
10,SUDHA VEERA GANESH,Independent,2645,2,2647,0.2,S016
11,BHAVANI SANKAR PRASAD MERLA,Independent,1963,6,1969,0.15,S016
12,YENUGUPALLI KRISHNA,Jaibhim Rao Bharat Party,1762,18,1780,0.13,S016
13,BODDETI APPARAO,Independent,1687,0,1687,0.13,S016
14,NEELAKANTAM DONAM,Independent,1401,11,1412,0.11,S016
15,PASUPULETI S.V.S.BHUSHANAM,Independent,1222,5,1227,0.09,S016
16,NOTA,None of the Above,17105,115,17220,1.29,S016
1,SATPAL BRAHAMCHARI,Indian National Congress,546163,2519,548682,48.82,S076
2,MOHAN LAL BADOLI,Bharatiya Janata Party,525069,1797,526866,46.88,S076
3,UMESH KUMAR,Bahujan Samaj Party,12742,80,12822,1.14,S076
4,ANOOP SINGH,Indian National Lok Dal,11384,139,11523,1.03,S076
5,BHUPENDER SINGH MALIK,Jannayak Janta Party,7716,104,7820,0.7,S076
6,SANT DHARAMVEER CHOTIVALA,Independent,2150,4,2154,0.19,S076
7,RAMESH,Independent,1651,0,1651,0.15,S076
8,NARESH KASHYAP,Aam Aadmi Parivartan Party,1622,36,1658,0.15,S076
9,SATPAL,Independent,1215,2,1217,0.11,S076
10,GAUBHAGAT SUMIT LATHER,Independent,877,5,882,0.08,S076
11,DR. KAMLESH KUMAR SAINI,Independent,863,3,866,0.08,S076
12,ROHTASH,Independent,775,2,777,0.07,S076
13,BALBIR SINGH,Socialist Unity Centre Of India (COMMUNIST),765,3,768,0.07,S076
14,ASHWANI,Independent,694,1,695,0.06,S076
15,SANJAY DASS,Independent,569,3,572,0.05,S076
16,JAGBEER,Independent,521,3,524,0.05,S076
17,SUNIL KUMAR,Rashtriya Garib Dal,456,11,467,0.04,S076
18,RADHEY SHYAM,Peoples Party of India (Democratic),438,3,441,0.04,S076
19,RAKESH,Samata Party,407,3,410,0.04,S076
20,NIRMAL SINGH,Independent,317,1,318,0.03,S076
21,SURENDER SINGH,Independent,295,1,296,0.03,S076
22,RAKESH DHARIWAL,Rashtriya Jatigat Aarakshan Virodhi Party,214,1,215,0.02,S076
23,NOTA,None of the Above,2287,33,2320,0.21,S076
1,"ANNADURAI, C.N.",Dravida Munnetra Kazhagam,543857,3522,547379,47.75,S2211
2,KALIYAPERUMAL M,All India Anna Dravida Munnetra Kazhagam,311384,2064,313448,27.34,S2211
3,"ASUVATHAMAN, A.",Bharatiya Janata Party,154736,1914,156650,13.67,S2211
4,"RAMESHBABU,  R.",Naam Tamilar Katchi,83148,721,83869,7.32,S2211
5,"KALIAPERUMAL, M.",Independent,5704,9,5713,0.5,S2211
6,"BENNYRAJAN, C.J.",Bharatiya Praja Aikyata Party,4703,107,4810,0.42,S2211
7,"KALIYAPERUMAL, A.",Independent,3402,5,3407,0.3,S2211
8,"MOHANRAJA,  V.M.",Bahujan Samaj Party,2615,22,2637,0.23,S2211
9,CAPTAIN GOWTHAM,Independent,1823,19,1842,0.16,S2211
10,"UDHAYAKUMAR, P.S.",Independent,1246,5,1251,0.11,S2211
11,"ANNADURAI, S.",Independent,1165,7,1172,0.1,S2211
12,"KOTHANDABANI, B.",Independent,963,2,965,0.08,S2211
13,"SELVAM , K.",Veerath Thiyagi Viswanathadoss Thozhilalarkal Katchi,945,9,954,0.08,S2211
14,"KALASTHIRI,  S.",All India Uzhavargal Uzhaippalargal Katchi,934,16,950,0.08,S2211
15,"VIJAYAKUMAR,  S.",Independent,928,6,934,0.08,S2211
16,"JAGANNATHAN,  R.",Independent,857,7,864,0.08,S2211
17,"SENTHAMIL SELVAN,  M.",Independent,848,8,856,0.07,S2211
18,"AGNI SELVARASU, J.",Naadaalum Makkal Katchi,759,18,777,0.07,S2211
19,"SATHIYAMOORTHY,  S.",Makkal Nala Kazhagam,716,20,736,0.06,S2211
20,"ANNADURAI, S.",Independent,642,6,648,0.06,S2211
21,"SUB MAJOR SETTU, M.",Viro Ke Vir Indian Party,636,22,658,0.06,S2211
22,"SANKAR,  S.",Independent,569,9,578,0.05,S2211
23,"ANNADURAI, A.",Independent,482,34,516,0.05,S2211
24,"NALLASIVAM, M.",Independent,426,3,429,0.04,S2211
25,"PALANI , T.N.",Independent,413,1,414,0.04,S2211
26,"POONGODY,  A.",Independent,412,5,417,0.04,S2211
27,"VIMAL, V.",Independent,341,1,342,0.03,S2211
28,"THANGARAJ,  P.",Independent,291,4,295,0.03,S2211
29,"RAMESH , T.P.",Independent,280,1,281,0.02,S2211
30,"NAKKEERAN ,  A.",Independent,260,5,265,0.02,S2211
31,DEEPAMMAL SUNDARI,Independent,252,7,259,0.02,S2211
32,NOTA,None of the Above,11527,430,11957,1.04,S2211
1,MANOJ KUMAR,Indian National Congress,509977,3027,513004,46.76,S0434
2,SHIVESH KUMAR,Bharatiya Janata Party,492177,1670,493847,45.01,S0434
3,SANTOSH KUMAR,Bahujan Samaj Party,45491,107,45598,4.16,S0434
4,SHIV SHANKAR RAM,Independent,8009,10,8019,0.73,S0434
5,SANTOSH KUMAR KHARWAR,Bhartiya Gandhiwadi Party,4817,5,4822,0.44,S0434
6,BANARSI DAS,Peoples Party of India (Democratic),4498,0,4498,0.41,S0434
7,AMIT KUMAR AMBEDKAR,Bahujan Mukti Party,2823,11,2834,0.26,S0434
8,PUNAM DEVI,Jantantra Awaj Party,2634,20,2654,0.24,S0434
9,UJARAN MUSAHAR,Jan Janwadi Party,2616,4,2620,0.24,S0434
10,NANDLAL RAM,Rashtriya Samaj Paksha,1956,4,1960,0.18,S0434
11,NOTA,None of the Above,17160,59,17219,1.57,S0434
1,KIREN RIJIJU,Bharatiya Janata Party,196415,9002,205417,51.38,S021
2,NABAM TUKI,Indian National Congress,100100,4579,104679,26.18,S021
3,TECHI RANA,Independent,31106,2208,33314,8.33,S021
4,TOKO SHEETAL,Gana Suraksha Party,27670,2860,30530,7.64,S021
5,BIMPAK SIGA,Independent,10569,949,11518,2.88,S021
6,RUHI TAGUNG,Independent,7559,262,7821,1.96,S021
7,LEKI NORBU,Independent,2139,132,2271,0.57,S021
8,TANIA JUNE,Independent,1920,38,1958,0.49,S021
9,NOTA,None of the Above,2133,163,2296,0.57,S021
1,GIRIRAJ SINGH,Bharatiya Janata Party,646912,2419,649331,50.15,S0424
2,ABDHESH KUMAR ROY,Communist Party of India,564310,3541,567851,43.86,S0424
3,INDRAJEET KUMAR ROY,Independent,12947,6,12953,1,S0424
4,RAJNISH KUMAR MUKHIYA,Rashtriya Jansambhavna Party,10846,26,10872,0.84,S0424
5,ADV CHANDAN KUMAR DAS,Bahujan Samaj Party,8362,91,8453,0.65,S0424
6,RAM BADAN RAI,Karpoori Janta Dal,6599,45,6644,0.51,S0424
7,MD SHAHNAWAZ HASSAN,Independent,6144,8,6152,0.48,S0424
8,ARUN KUMAR,Independent,4030,15,4045,0.31,S0424
9,RAJ KUMAR SAH,Akhil Bhartiya Parivar Party,3329,21,3350,0.26,S0424
10,RAMUDGAR,Socialist Unity Centre Of India (COMMUNIST),2633,7,2640,0.2,S0424
11,NOTA,None of the Above,22283,99,22382,1.73,S0424
1,SANJNA JATAV,Indian National Congress,572808,7082,579890,51.18,S209
2,RAMSWAROOP KOLI,Bharatiya Janata Party,519269,8638,527907,46.59,S209
3,ANJILA JATAV,Bahujan Samaj Party,9298,210,9508,0.84,S209
4,ANEETA,Independent,5027,92,5119,0.45,S209
5,PURUSHOTTAM LAL,Independent,2730,17,2747,0.24,S209
6,PUSHPENDAR KUMAR,Independent,2374,12,2386,0.21,S209
7,NOTA,None of the Above,5344,99,5443,0.48,S209
1,DR DHARAMVIRA GANDHI,Indian National Congress,304672,944,305616,26.54,S1913
2,DR BALBIR SINGH,Aam Aadmi Party,290085,700,290785,25.25,S1913
3,PRENEET KAUR,Bharatiya Janata Party,288470,528,288998,25.09,S1913
4,N K SHARMA,Shiromani Akali Dal,153780,198,153978,13.37,S1913
5,PROF MOHINDER PAL SINGH,Shiromani Akali Dal (Amritsar)(Simranjit Singh Mann),47152,122,47274,4.1,S1913
6,JAGJIT SINGH CHHARBAR,Bahujan Samaj Party,22334,66,22400,1.94,S1913
7,ARVINDER KUMAR,Independent,3808,4,3812,0.33,S1913
8,JAGDISH KUMAR,Independent,3236,3,3239,0.28,S1913
9,SUKHVINDER SINGH,Independent,2885,9,2894,0.25,S1913
10,JODH SINGH PARMAR KAULI,Independent,2795,0,2795,0.24,S1913
11,DEVINDER RAJPUT,Bharatheeya Jawan Kisan Party,2302,9,2311,0.2,S1913
12,NEERAJ KUMAR NANNA,Independent,2299,3,2302,0.2,S1913
13,PARAMJIT SINGH S/O TARLOCHAN SINGH,Independent,2264,3,2267,0.2,S1913
14,AMARJIT SINGH JAGDE RAHO,Jan Janwadi Party,1981,11,1992,0.17,S1913
15,RANJIT SINGH,Akhil Bhartiya Parivar Party,1964,3,1967,0.17,S1913
16,GURBACHAN SINGH,Independent,1589,5,1594,0.14,S1913
17,PARAMJIT SINGH S/O BHAGWAN SINGH,Independent,1565,4,1569,0.14,S1913
18,VISHAL SHARMA,Independent,1474,1,1475,0.13,S1913
19,LABH SINGH PAL,Independent,1443,0,1443,0.13,S1913
20,CHAMKILA SINGH,Independent,1225,3,1228,0.11,S1913
21,KRISHAN KUMAR GABA,Hindustan Shakti Sena,1000,8,1008,0.09,S1913
22,MANDEEP SINGH,Revolutionary Socialist Party,970,3,973,0.08,S1913
23,MAKHAN SINGH,Independent,904,3,907,0.08,S1913
24,DIMPLE,Independent,846,4,850,0.07,S1913
25,BINDER KAUR,Independent,707,4,711,0.06,S1913
26,MANOJ KUMAR,Independent,674,0,674,0.06,S1913
27,NOTA,None of the Above,6641,40,6681,0.58,S1913
1,ADV GOWAAL KAGADA PADAVI,Indian National Congress,744879,1119,745998,53.53,S131
2,DR HEENA VIJAYKUMAR GAVIT,Bharatiya Janata Party,585847,1031,586878,42.11,S131
3,ANANDA SUKALAL KOLI,Bahujan Samaj Party,10628,16,10644,0.76,S131
4,SUSHILKUMAR JAHANGIR PAWARA,Independent,8878,9,8887,0.64,S131
5,NIRMALA VASAVE,Peoples Party of India (Democratic),6923,24,6947,0.5,S131
6,ROHIDAS GEMAJI VALVI,Independent,4941,6,4947,0.35,S131
7,HEMANT MANSARAM KOLI,Vanchit Bahujan  Aaghadi,4062,19,4081,0.29,S131
8,DEEPAKKUMAR MADHUKAR SHIRSATH,Independent,3567,4,3571,0.26,S131
9,RAVINDRA RANJIT VALVI,Bharat Adivasi Party,2608,17,2625,0.19,S131
10,JALAMSING SUTUM PAWAR,Independent,2583,4,2587,0.19,S131
11,GITANJALI SHASHIKANT KOLI,Independent,2372,9,2381,0.17,S131
12,NOTA,None of the Above,14108,15,14123,1.01,S131
1,AKSHAYA YADAV,Samajwadi Party,541861,1176,543037,49.04,S2420
2,VISHWADEEP SINGH,Bharatiya Janata Party,452946,779,453725,40.98,S2420
3,CHOWDHARY BASHEER,Bahujan Samaj Party,90849,99,90948,8.21,S2420
4,UPENDRA SINGH,Bharatiya Kisan Parivartan Party,7111,8,7119,0.64,S2420
5,RASHMI KANT,Parivartan Samaj Party,2927,3,2930,0.26,S2420
6,PREM DUTT,Rashtra Uday Party,2876,2,2878,0.26,S2420
7,RAJVEER,Independent,1367,13,1380,0.12,S2420
8,NOTA,None of the Above,5273,6,5279,0.48,S2420
1,VISHNU DATT SHARMA (V.D.SHARMA),Bharatiya Janata Party,771014,1760,772774,67.75,S128
2,KAMLESH KUMAR,Bahujan Samaj Party,231163,382,231545,20.3,S128
3,R. B. PRAJAPATI (RAJA BHAIYA) EX.I.A.S.,All India Forward Bloc,50033,182,50215,4.4,S128
4,MOHAMMAD IMRAN,Rashtriya Jansambhavna Party,17853,20,17873,1.57,S128
5,PENTER SUNMAN SINGH LODHI,Independent,10005,6,10011,0.88,S128
6,KAPIL GUPTA BHARTIYA,Akhil Bhartiya Parivar Party,7540,24,7564,0.66,S128
7,LAXMI PRASAD,Independent,6752,12,6764,0.59,S128
8,NANDKISHOR,Peoples Party of India (Democratic),6019,8,6027,0.53,S128
9,PANKAJ MAURYA (KUSHWAHA),Gondvana Gantantra Party,4730,10,4740,0.42,S128
10,BITIAYA AHIRWAR,Independent,4018,8,4026,0.35,S128
11,FIROJKHAN,Independent,3708,5,3713,0.33,S128
12,GIRAN SINGH,Bhartiya Shakti Chetna Party,3485,7,3492,0.31,S128
13,KESHKALI,Rashtriya Jansanchar Dal,2861,11,2872,0.25,S128
14,PANNA LAL TRIPATHI AD.,Indian Peoples Adhikar Party,2794,3,2797,0.25,S128
15,NOTA,None of the Above,16134,23,16157,1.42,S128
1,"SUBBARAYAN, K.",Communist Party of India,470195,2544,472739,41.38,S2218
2,"ARUNACHALAM, P.",All India Anna Dravida Munnetra Kazhagam,345326,1485,346811,30.35,S2218
3,"MURUGANANDAM, A.P.",Bharatiya Janata Party,184066,1256,185322,16.22,S2218
4,"SEETHALAKSHMI, M.K.",Naam Tamilar Katchi,95250,476,95726,8.38,S2218
5,"VELUSAMY, A.",Independent,7089,36,7125,0.62,S2218
6,"PALANI, V.",Bahujan Samaj Party,6013,41,6054,0.53,S2218
7,"SATHISHKUMAR, N.",Independent,2315,21,2336,0.2,S2218
8,"JANARTHANAM, P.",Tamilaga Makkal Thannurimai Katchi,1861,7,1868,0.16,S2218
9,"KANNAN, M.",Independent,1752,13,1765,0.15,S2218
10,"SENGUTTUVAN, M.R.",Independent,1560,7,1567,0.14,S2218
11,"SUBRAMANI, N.",Independent,1341,9,1350,0.12,S2218
12,"MALARVIZHI, G.",Rashtriya Samaj Paksha,1311,14,1325,0.12,S2218
13,"KARTHIKEYAN, P.",Independent,810,14,824,0.07,S2218
14,NOTA,None of the Above,17554,183,17737,1.55,S2218
1,P C MOHAN,Bharatiya Janata Party,657236,1679,658915,50.05,S1025
2,MANSOOR ALI KHAN,Indian National Congress,625368,840,626208,47.57,S1025
3,SATISH CHANDRA. M.,Bahujan Samaj Party,3071,16,3087,0.23,S1025
4,JAYALAKSHMI SUNDARA RAJAN,Independent,2755,6,2761,0.21,S1025
5,SURESH BABU. M. C,Uttama Prajaakeeya Party,1735,4,1739,0.13,S1025
6,K. MANJUNATHA,Independent,1552,4,1556,0.12,S1025
7,S. M. KRISHNA,Independent,1466,8,1474,0.11,S1025
8,MURUGESH. R,Independent,1162,0,1162,0.09,S1025
9,UMA. V.,Independent,820,7,827,0.06,S1025
10,PRAKASH. K,Karnataka Rashtra Samithi,766,13,779,0.06,S1025
11,H. P. SHIVAPRAKASH,Socialist Unity Centre Of India (COMMUNIST),700,7,707,0.05,S1025
12,MODI SAIFULLA,Independent,688,7,695,0.05,S1025
13,ABHAYA SHEELA.,Rashtriya Samaj Dal (R),625,10,635,0.05,S1025
14,KARTHIK. K,Voters Independent Party,594,7,601,0.05,S1025
15,T.R. JAGANNATHA RAO,Bharatiya Prajagala Kalyana Paksha,456,4,460,0.03,S1025
16,VASANTH KUMAR ERAPPA,Independent,439,0,439,0.03,S1025
17,C.M. SHABAZ KHAN,Young Star Empowerment Party,428,1,429,0.03,S1025
18,WHITEFIELD MURUGESH .C,Republican Party of India (Karnataka),376,2,378,0.03,S1025
19,B. KRISHNA PRASAD,"Proutist Bloc, India",324,3,327,0.02,S1025
20,MUKTHAR ALI KHAN,Karnataka Karmikara Paksha,314,0,314,0.02,S1025
21,SYED ASIF BUKHARI,Independent,286,0,286,0.02,S1025
22,RANJITH VISHWA,Samajwadi Janata Party(Karnataka),270,4,274,0.02,S1025
23,RUMAN SHARIFFE,Independent,170,1,171,0.01,S1025
24,YALLAPPA.,Independent,158,2,160,0.01,S1025
25,NOTA,None of the Above,12103,23,12126,0.92,S1025
1,SUNIL KUMAR,Janata Dal  (United),522495,927,523422,47.5,S041
2,DEEPAK YADAV,Rashtriya Janata Dal,422959,1788,424747,38.55,S041
3,PRAVESH KUMAR MISHRA @ ANUP,Independent,23195,30,23225,2.11,S041
4,DINESH AGRAWAL,Independent,19787,23,19810,1.8,S041
5,DURGESH SINGH CHAUHAN,Bahujan Samaj Party,18739,77,18816,1.71,S041
6,CHANDRESHWAR MISHRA,Independent,13590,8,13598,1.23,S041
7,SHAFI MOHAMMAD MIYA,Aazad Samaj Party (Kanshi Ram),13419,13,13432,1.22,S041
8,PARSHURAM SAH,Independent,12142,8,12150,1.1,S041
9,NABA KUMAR SARANIA (HIRA BHAI),Gana Suraksha Party,11420,3,11423,1.04,S041
10,SHAMBHU PRASAD,Independent,10478,20,10498,0.95,S041
11,NOTA,None of the Above,30673,36,30709,2.79,S041
1,JADHAV SANJAY ( BANDU ) HARIBHAU,Shiv Sena (Uddhav Balasaheb Thackrey),596871,4472,601343,45.17,S1317
2,JANKAR MAHADEV JAGANNATH,Rashtriya Samaj Paksha,463764,3518,467282,35.1,S1317
3,PANJAB UTTAMRAO DAKH,Vanchit Bahujan  Aaghadi,95394,573,95967,7.21,S1317
4,DR. GOVARDHAN BHIWAJI KHANDAGALE,Bahujan Bharat Party,15355,40,15395,1.16,S1317
5,KAMBLE SHIVAJI DEVAJI,Independent,11050,10,11060,0.83,S1317
6,ALAMGIR MOHAMMAD KHAN,Bahujan Samaj Party,10972,90,11062,0.83,S1317
7,SAMIR GANESHRAO DUDHGAONKAR,Independent,10951,105,11056,0.83,S1317
8,KRUSHNA TRIMBAKRAO PAWAR,Independent,10145,9,10154,0.76,S1317
9,KAILAS BALIRAM PAWAR (NAIK),Baliraja Party,9487,33,9520,0.72,S1317
10,PROF. DR. VILAS BANSIDHAR TANGADE,Independent,8814,6,8820,0.66,S1317
11,ARJUN DNYANOBA BHISE,Independent,6915,8,6923,0.52,S1317
12,COMRADE RAJAN KSHIRSAGAR,Communist Party of India,6627,22,6649,0.5,S1317
13,KISHORKUMAR PRAKASH SHINDE,Independent,6547,1,6548,0.49,S1317
14,KISHORE RADHAKISHAN DHAGE,Independent,5446,34,5480,0.41,S1317
15,SAYED IRSHAD ALI SAYYED LAYAKH ALI,Social Democratic Party Of India,4629,15,4644,0.35,S1317
16,DASHARATH PRABHKAR RATHOD,Maharashtra Vikas Aghadi,4354,40,4394,0.33,S1317
17,KARBHARI KUNDLIK MITHE,Independent,4268,8,4276,0.32,S1317
18,APPASAHEB OMKAR KADAM,Independent,3883,8,3891,0.29,S1317
19,SHRIRAM BANSILAL JADHAV,Jai Sewalal Bahujan Vikas Party,3617,11,3628,0.27,S1317
20,COMRADE GANPAT BHISE,Independent,3589,15,3604,0.27,S1317
21,DNYANESHWAR JAGANNATH DAHIBHATE,Independent,3538,1,3539,0.27,S1317
22,ANIL MANIKRAO MUDGALKAR,Independent,3531,2,3533,0.27,S1317
23,GOVIND BHAIYYA RAMRAO DESHMUKH,Independent,3452,7,3459,0.26,S1317
24,SUBHASH DATTARAV JAVLE,Independent,3429,5,3434,0.26,S1317
25,RAJABHAU SHESHRAO KAKDE,Independent,3299,3,3302,0.25,S1317
26,RAJENDRA RAMDAS ATKAL,Independent,2807,5,2812,0.21,S1317
27,SAYYD ABDUL SATTAR AJIJ,Independent,2646,4,2650,0.2,S1317
28,SHAIKH SALEEM SHAIKH IBRAHIM,All India Majlis-E-Inquilab-E-Millat,2617,2,2619,0.2,S1317
29,SANGEETA VYAKANTRAO GIRI,Swarajya Shakti Sena,2324,15,2339,0.18,S1317
30,ADV. VINOD CHHAGANRAO AMBHORE,Bahujan Mukti Party,2017,24,2041,0.15,S1317
31,VIJAY ANNASAHEB THOMBARE,Independent,1957,2,1959,0.15,S1317
32,VISHNUDAS SHIVAJI BHOSALE,Independent,1856,4,1860,0.14,S1317
33,MUSTAFA MAINODDIN SHAIKH,Independent,1298,4,1302,0.1,S1317
34,BOBADE SAKHARAM PADEGAONKAR,Independent,1244,2,1246,0.09,S1317
35,NOTA,None of the Above,3306,79,3385,0.25,S1317
1,MANNA LAL RAWAT,Bharatiya Janata Party,732757,5529,738286,49.27,S2019
2,TARACHAND MEENA,Indian National Congress,473167,3511,476678,31.81,S2019
3,PRAKASH CHAND,Bharat Adivasi Party,215390,1748,217138,14.49,S2019
4,DALPAT RAM GARASIA,Bahujan Samaj Party,14427,33,14460,0.97,S2019
5,DR. SAVITA KUMARI AHARI,Independent,8130,32,8162,0.54,S2019
6,PRABHULAL MEENA,Independent,7972,24,7996,0.53,S2019
7,RAJENDRA KUMAR MEENA,Indian Peoples Green Party,6752,25,6777,0.45,S2019
8,KANJI LAL DAMOR,Independent,5912,19,5931,0.4,S2019
9,NOTA,None of the Above,22848,100,22948,1.53,S2019
1,SURESH GOPI,Bharatiya Janata Party,409302,3036,412338,37.8,S1110
2,ADV V S SUNILKUMAR,Communist Party of India,334462,3190,337652,30.95,S1110
3,K MURALEEDHARAN,Indian National Congress,324810,3314,328124,30.08,S1110
4,ADV P K NARAYANAN,Bahujan Samaj Party,1985,34,2019,0.19,S1110
5,SUNILKUMAR SON OF PRABHAKARAN,Independent,1930,22,1952,0.18,S1110
6,DIVAKARAN PALLATH,New Labour Party,812,7,819,0.08,S1110
7,M S JAFARGHAN,Independent,689,9,698,0.06,S1110
8,PRATHAPAN,Independent,685,24,709,0.06,S1110
9,JOSHI VILLADOM,Independent,460,33,493,0.05,S1110
10,NOTA,None of the Above,6046,26,6072,0.56,S1110
1,PRABHAKAR REDDY VEMIREDDY,Telugu Desam,750771,15431,766202,55.7,S0122
2,VENUMBAKA VIJAYASAI REDDY,Yuvajana Sramika Rythu Congress Party,514375,5925,520300,37.82,S0122
3,KOPPULA RAJU,Indian National Congress,53264,1580,54844,3.99,S0122
4,BHASKAR NASINA,Bahujan Samaj Party,5710,101,5811,0.42,S0122
5,VIVEKA MANNEPALLI,Revolutionary Socialist Party,2794,10,2804,0.2,S0122
6,KOPPALA RAGHU,Independent,2010,5,2015,0.15,S0122
7,GAJULA SOMA SEKHAR,Jai Bharat National Party,1775,4,1779,0.13,S0122
8,SHAIK MUZIBUR RAHAMAN,Pyramid Party of India,1315,15,1330,0.1,S0122
9,SHAIK MAHABOOB BASHA (MABU),Republican Party of India (A),1228,5,1233,0.09,S0122
10,MALLEPALLY RAGHU,Navarang Congress Party,1104,1,1105,0.08,S0122
11,SHAIK SHAFI AHMED,All India Forward Bloc,1037,0,1037,0.08,S0122
12,NAKKA DINESH,Bharatha Chaitanya Yuvajana Party,576,24,600,0.04,S0122
13,TALARI VENKATAIAH,Jaibhim Rao Bharat Party,553,5,558,0.04,S0122
14,PUNGANURU PRASANNA GANAPATHI,Radical Party of India (Ambedkarist),452,2,454,0.03,S0122
15,NOTA,None of the Above,15454,123,15577,1.13,S0122
1,CAPTAIN  VIRIATO FERNANDES,Indian National Congress,216022,1814,217836,48.35,S052
2,PALLAVI SHRINIVAS DEMPO,Bharatiya Janata Party,201806,2495,204301,45.35,S052
3,RUBERT PEREIRA,Revolutionary Goans Party,18718,167,18885,4.19,S052
4,DR SWETA GAONKAR,Bahujan Samaj Party,1545,36,1581,0.35,S052
5,DEEPKUMAR D MAPARI,Independent,1309,8,1317,0.29,S052
6,DR KALIDAS VAINGANKAR,Independent,707,13,720,0.16,S052
7,ALEXY FERNANDES,Independent,526,16,542,0.12,S052
8,HARISHCHANDRA SUDHAKAR NAIK,Corruption Abolition Party,487,14,501,0.11,S052
9,NOTA,None of the Above,4804,33,4837,1.07,S052
1,LAVU SRIKRISHNA DEVARAYALU,Telugu Desam,798097,9899,807996,53.88,S0114
2,ANIL KUMAR POLUBOINA,Yuvajana Sramika Rythu Congress Party,642186,6081,648267,43.23,S0114
3,GARNEPUDI ALEXANDER SUDHAKAR,Indian National Congress,17520,526,18046,1.2,S0114
4,ORSU PREMARAJU,Bahujan Samaj Party,5276,33,5309,0.35,S0114
5,KUCHIPUDI JOHN BABU,Jaibhim Rao Bharat Party,2328,8,2336,0.16,S0114
6,GARLAPATI SUBHASH PREM,Revolutionary Socialist Party,1243,2,1245,0.08,S0114
7,YAMPATI VEERANJANEYA REDDY,Independent,1056,1,1057,0.07,S0114
8,SUBBARAO CHALLA,Independent,1051,0,1051,0.07,S0114
9,ABDUL RAJAK SHAIK,Independent,718,5,723,0.05,S0114
10,KOTA POTHURAJU,Pyramid Party of India,667,3,670,0.04,S0114
11,P VENKATESH,Jaathia Chethi Vruthula Ikya Vedika Party,385,3,388,0.03,S0114
12,PASUPULETI PICHAIAH,National Nava Kranthi Party,353,3,356,0.02,S0114
13,PAPPULA SAMBASIVA RAO,Navarang Congress Party,331,1,332,0.02,S0114
14,DOCTOR GODA RAMESH KUMAR,Jatiya Jana Sena Party,305,4,309,0.02,S0114
15,THOKALA NAGA RAJU,All India Forward Bloc,277,8,285,0.02,S0114
16,NOTA,None of the Above,11120,79,11199,0.75,S0114
1,C R PATIL,Bharatiya Janata Party,1023366,7699,1031065,77.05,S0625
2,NAISHADHBHAI BHUPATBHAI  DESAI,Indian National Congress,254567,2947,257514,19.24,S0625
3,MALKHAN RAMKISHOR VARMA,Bahujan Samaj Party,8076,57,8133,0.61,S0625
4,KIRIT L. SURATI,Independent,4190,21,4211,0.31,S0625
5,RAJU VARDE,Independent,3139,45,3184,0.24,S0625
6,RAMZAN MANSURI (SENIOR JOURNALIST),Log Party,2652,1,2653,0.2,S0625
7,KADIR MAHEBOOB SAIYED,Social Democratic Party Of India,2527,11,2538,0.19,S0625
8,SHEKH MOHMMAD NISHAR (MUNNABHAI GARAGE),Independent,1481,2,1483,0.11,S0625
9,DR. KANUBHAI KHADADIYA,Socialist Unity Centre Of India (COMMUNIST),1470,15,1485,0.11,S0625
10,SUMANBEN  KHUSHWA (HANSIKA RAJPUT),Sardar Vallabhbhai Patel Party,1397,29,1426,0.11,S0625
11,ADVOCATE NAVINKUMAR SHANKERBHAI PATEL,Independent,1091,4,1095,0.08,S0625
12,MOHAMMAD HANIF SHAH,Garib Kalyan Party,1089,8,1097,0.08,S0625
13,CHANDANSINGH SHIVBADANSINGH THAKUR,Independent,1070,17,1087,0.08,S0625
14,KAZI AYAZ HUSNUDDIN,Independent,775,8,783,0.06,S0625
15,NOTA,None of the Above,19653,809,20462,1.53,S0625
1,MAHESH KASHYAP,Bharatiya Janata Party,456573,1825,458398,45.5,S2610
2,KAWASI LAKHMA,Indian National Congress,402378,775,403153,40.02,S2610
3,PHULSINGH KACHLAM,Communist Party of India,35850,37,35887,3.56,S2610
4,AYTU RAM MANDAVI,Bahujan Samaj Party,19615,32,19647,1.95,S2610
5,SUNDAR BAGHEL,Independent,14203,4,14207,1.41,S2610
6,PRAKASH KUMAR GOTA,Independent,11209,36,11245,1.12,S2610
7,KANWAL SINGH BAGHEL,Rashtriya Jansabha Party,8785,15,8800,0.87,S2610
8,SHIVRAM NAG,Sarv Adi Dal,8269,10,8279,0.82,S2610
9,NARENDRA BURKA,Hamar Raj Party,4382,5,4387,0.44,S2610
10,JAGDISH NAG,Azad Janata Party,3569,23,3592,0.36,S2610
11,TIKAM NAGWANSHI,Gondvana Gantantra Party,3030,12,3042,0.3,S2610
12,NOTA,None of the Above,36733,25,36758,3.65,S2610
1,SHAMBHAVI,Lok Janshakti Party(Ram Vilas),579095,691,579786,52.97,S0423
2,SUNNY HAZARI,Indian National Congress,391558,977,392535,35.86,S0423
3,SHASHI BHUSHAN DAS,Independent,25953,4,25957,2.37,S0423
4,RAVI RAUSHAN KUMAR,Independent,16151,4,16155,1.48,S0423
5,RAM LAKHAN  MAHTO,Bahujan Samaj Party,12698,34,12732,1.16,S0423
6,PINKU PASWAN,Rashtriya Jansambhavna Party,12426,11,12437,1.14,S0423
7,MUKESH CHAUPAL,Independent,5574,5,5579,0.51,S0423
8,JIBACHH KUMAR HAJARI,Independent,4686,8,4694,0.43,S0423
9,RATAN BIHARI,Desh Janhit Party,3411,8,3419,0.31,S0423
10,VIDYA NAND RAM,Wazib Adhikar Party,3110,2,3112,0.28,S0423
11,AMRITA KUMARI,Independent,2849,3,2852,0.26,S0423
12,LAL BABU MAHTO,Sathi Aur Aapka Faisala Party,2665,1,2666,0.24,S0423
13,NOTA,None of the Above,32645,23,32668,2.98,S0423
1,VIVEK THAKUR,Bharatiya Janata Party,408537,2071,410608,47.2,S0439
2,SHRAWAN KUMAR,Rashtriya Janata Dal,340562,2376,342938,39.42,S0439
3,BINOD YADAV,Independent,39391,128,39519,4.54,S0439
4,GUNJAN KUMAR,Independent,29444,238,29682,3.41,S0439
5,RANJIT KUMAR,Bahujan Samaj Party,16240,76,16316,1.88,S0439
6,ANAND KUMAR VERMA,Bharat Jan Jagran Dal,7727,9,7736,0.89,S0439
7,GAUTAM KUMAR BABLOO,Bhagidari Party(P),5886,3,5889,0.68,S0439
8,GANAURI PANDIT,Peoples Party of India (Democratic),4558,32,4590,0.53,S0439
9,NOTA,None of the Above,12555,37,12592,1.45,S0439
1,NIMUBEN JAYANTIBHAI BAMBHANIYA (NIMUBEN BAMBHANIYA),Bharatiya Janata Party,707428,9455,716883,68.46,S0615
2,UMESHBHAI NARANBHAI MAKWANA,Aam Aadmi Party,256902,4692,261594,24.98,S0615
3,RATHOD DINESHBHAI LAKHABHAI,Bahujan Samaj Party,9989,141,10130,0.97,S0615
4,ANILBHAI NARENDRABHAI CHAVDA,Swatantrata Abhivyakti Party,7574,45,7619,0.73,S0615
5,PARMAR RAJESHKUMAR PREMJIBHAI,New India United Party,6456,37,6493,0.62,S0615
6,KALANIYA SAGARBHAI POPATBHAI,Aapki Awaaz Party,6039,48,6087,0.58,S0615
7,SANJAYBHAI MAGANBHAI MAKAWANA,Independent,4131,22,4153,0.4,S0615
8,HARSH GOKLANI,Independent,3593,41,3634,0.35,S0615
9,SHRI MULSHANKARBHAI RAGHURAMBHAI CHAUHAN,Independent,3386,20,3406,0.33,S0615
10,SHRI TIDABHAI DEVSHIBHAI,Gujarat Sarva Samaj Party,2641,44,2685,0.26,S0615
11,BHUPATBHAI MOHANBHAI VALA,Right to Recall Party,2370,24,2394,0.23,S0615
12,NARESHBHAI NARANBHAI RATHOD,Independent,1745,20,1765,0.17,S0615
13,BRAHMAKSHTRIYA BHAGVATIBEN KHETSINH,Independent,1562,62,1624,0.16,S0615
14,NOTA,None of the Above,17717,1048,18765,1.79,S0615
1,RAJA RAM SINGH,Communist Party of India  (Marxist-Leninist)  (Liberation),378922,1659,380581,36.89,S0435
2,PAWAN SINGH,Independent,273546,1177,274723,26.63,S0435
3,UPENDRA KUSHWAHA,Rashtriya Lok Morcha,253088,788,253876,24.61,S0435
4,DHEERAJ KUMAR SINGH,Bahujan Samaj Party,23549,108,23657,2.29,S0435
5,RAJA RAM SINGH,Independent,21357,26,21383,2.07,S0435
6,PRIYANKA PRASAD CHOUDHARY,All India Majlis-E-Ittehadul Muslimeen,10983,23,11006,1.07,S0435
7,AJEET KUMAR SINGH,Peoples Party of India (Democratic),9634,19,9653,0.94,S0435
8,VIKASH VINAYAK,Jan Janwadi Party,7661,3,7664,0.74,S0435
9,INDRA RAJ ROUSHAN,Independent,6315,9,6324,0.61,S0435
10,PRADEEP KUMAR JOSHI,Rashtra Sewa Dal,5891,28,5919,0.57,S0435
11,AVADHESH PASAWAN,Bharatiya Aam Awam Party,5527,58,5585,0.54,S0435
12,RAJESHWAR PASWAN,Akhil Hind Forward Bloc (Krantikari),5003,3,5006,0.49,S0435
13,PRAYAG PASWAN,Socialist Unity Centre Of India (COMMUNIST),4641,5,4646,0.45,S0435
14,NOTA,None of the Above,21548,47,21595,2.09,S0435
1,MISHA BHARTI,Rashtriya Janata Dal,612147,1136,613283,49.86,S0431
2,RAM KRIPAL YADAV,Bharatiya Janata Party,526608,1501,528109,42.93,S0431
3,DR S P SHARMA,Hindustan Vikas Dal,15139,1,15140,1.23,S0431
4,HARIKESHWAR RAM,Bahujan Samaj Party,10931,34,10965,0.89,S0431
5,VINDU DEVI,Rashtriya Jansambhavna Party,10741,3,10744,0.87,S0431
6,SHIV KUMAR SINGH,Apna Kisan Party,9011,5,9016,0.73,S0431
7,SANJAY KUMAR SINGH,Bhartiya Sarthak Party,4753,0,4753,0.39,S0431
8,MD FAROOQUE RAZA,All India Majlis-E-Ittehadul Muslimeen,4010,13,4023,0.33,S0431
9,RAM NIRANJAN ROY,Rashtrawadi Chetna Party,3914,1,3915,0.32,S0431
10,MRITUNJAY KUMAR,Bhagidari Party(P),3483,0,3483,0.28,S0431
11,DURGESH NANDAN SINGH,Independent,3104,2,3106,0.25,S0431
12,NAGESHWAR PRASAD,Peoples Party of India (Democratic),2048,3,2051,0.17,S0431
13,SUBHASH KUMAR,Bhartiya Lok Chetna Party,1979,0,1979,0.16,S0431
14,NITESH KUMAR PATEL,Adarsh Jankalyan Dal,1816,1,1817,0.15,S0431
15,RANJAN KUMAR,Independent,1807,2,1809,0.15,S0431
16,NIRAJ KUMAR,Independent,1767,4,1771,0.14,S0431
17,KUNAL KUMAR,Hamara Sahara Party,1607,7,1614,0.13,S0431
18,KHUSHBOO KUMARI,Akhil Bhartiya Parivar Party,1479,4,1483,0.12,S0431
19,ANIL DAS,Bhartiya Dalit Party,1465,4,1469,0.12,S0431
20,ANIL KUMAR CHAND,Socialist Unity Centre Of India (COMMUNIST),1421,3,1424,0.12,S0431
21,MADHURI KUMARI,All India Forward Bloc,1301,1,1302,0.11,S0431
22,JAWAHAR SINGH,Bhartiya Manavta Party,1235,2,1237,0.1,S0431
23,NOTA,None of the Above,5573,33,5606,0.46,S0431
1,Shyamkumar (Babalu) Daulat Barve,Indian National Congress,611894,1131,613025,48.94,S139
2,RAJU DEONATH PARVE,Shiv Sena,535234,1023,536257,42.81,S139
3,SANDIP SAHADEO MESHRAM,Bahujan Samaj Party,26003,95,26098,2.08,S139
4,KISHORE  UTTAMRAO GAJBHIYE,Independent,24324,59,24383,1.95,S139
5,AJAY BAKARAM CHAVAN,Independent,6021,5,6026,0.48,S139
6,SANVIDHAN G LOKHANDE,Baliraja Party,5810,4,5814,0.46,S139
7,ROSHANI ATUL GAJBHIYE,Gondvana Gantantra Party,5108,29,5137,0.41,S139
8,GOWARDHAN DEORAO KUMBHARE,Viro Ke Vir Indian Party,3750,16,3766,0.3,S139
9,ARVIND SHIVAJI TANDEKAR,Independent,3208,7,3215,0.26,S139
10,SANJAY VASANTRAO BORKAR,Maharashtra Vikas Aghadi,1983,9,1992,0.16,S139
11,SHANKAR CHINTAMAN CHAHANDE,Vanchit Bahujan  Aaghadi,1858,26,1884,0.15,S139
12,ADV BHIMRAO SHENDE,Bahujan Republican  Socialist Party,1811,7,1818,0.15,S139
13,GAIKWAD MANJUSHA SACHIN,Akhil Bhartiya Parivar Party,1760,13,1773,0.14,S139
14,ASHISH BHAURAO SARODE,Bhim Sena,1600,20,1620,0.13,S139
15,PRAMOD SHRIPAT KHOBRAGADE,Ambedkarite Party of India,1337,3,1340,0.11,S139
16,UMESH RAJU  KHADSE,Rashtra Samarpan Party,1223,6,1229,0.1,S139
17,SIDDHARTH GADIJI PATIL,Peoples Party of India (Democratic),975,2,977,0.08,S139
18,PREMKUMAR DASHRATH GAJBHARE,Independent,921,4,925,0.07,S139
19,RIDDHESHWAR ANANDRAO BELEY,Republican Party of India (A),908,5,913,0.07,S139
20,BHOJRAJ TUKARAM SARODE,Jay Vidarbha Party,881,7,888,0.07,S139
21,VILAS SHRIPAT KHADSE,Independent,857,3,860,0.07,S139
22,SUBHASH LOKHANDE,Independent,849,1,850,0.07,S139
23,KARTIK GENDLALJI DOKE,Independent,844,3,847,0.07,S139
24,ADV ULHAS SHALIKRAM DUPARE,Independent,780,1,781,0.06,S139
25,LAROKAR SURESH PUNDLIK,Independent,693,5,698,0.06,S139
26,SUNIL UTTAMRAO SALVE,Independent,649,2,651,0.05,S139
27,GOWARDHAN NAMDEO SOMDEVE,Independent,509,2,511,0.04,S139
28,VILAS GANESH ZODAPE,Independent,402,5,407,0.03,S139
29,NOTA,None of the Above,7769,58,7827,0.62,S139
1,BALASHOWRY VALLABHANENI,Janasena Party,712149,12290,724439,55.22,S0111
2,SIMHADRI CHANDRA SEKHAR RAO,Yuvajana Sramika Rythu Congress Party,495211,6049,501260,38.21,S0111
3,GOLLU KRISHNA,Indian National Congress,31130,695,31825,2.43,S0111
4,BAAL SHOURI CHODABATHINA,Jatiya Jana Sena Party,10518,623,11141,0.85,S0111
5,DEVAMANI DEVARAPALLI,Bahujan Samaj Party,9911,117,10028,0.76,S0111
6,KOMMARAJU SIVA NARASIMHA RAO,All India Forward Bloc,5245,9,5254,0.4,S0111
7,VALLABHANENI NAGA PAVAN KUMAR,Independent,5206,14,5220,0.4,S0111
8,MARADANI K R SWAMY,Jai Maha Bharath Party,2206,8,2214,0.17,S0111
9,GANDHI  DHANEKULA,Independent,1989,2,1991,0.15,S0111
10,PAMULA BALA SOWRYAMMA,Independent,1576,6,1582,0.12,S0111
11,ANUSHA YERUVA,Independent,1233,2,1235,0.09,S0111
12,GUDAVALLI VENKATA KEDARESWARA RAO,Independent,1102,9,1111,0.08,S0111
13,JOGI VEERANJANEYULU,Independent,1020,2,1022,0.08,S0111
14,DAMODARA RAO GUDAVALLI,Independent,928,2,930,0.07,S0111
15,APPARAO ENNETI,Independent,625,1,626,0.05,S0111
16,NOTA,None of the Above,12008,118,12126,0.92,S0111
1,SHANKAR LALWANI,Bharatiya Janata Party,1223746,3005,1226751,78.54,S1226
2,SANJAY S/O LAKSHMAN SOLANKI,Bahujan Samaj Party,51486,173,51659,3.31,S1226
3,PAWAN KUMAR,Akhil Bhartiya Parivar Party,15182,28,15210,0.97,S1226
4,ABHAY JAIN,Independent,8379,13,8392,0.54,S1226
5,LAVISH DILIP KHANDELWAL,Independent,8231,7,8238,0.53,S1226
6,COMRADE AJEET SINGH,Socialist Unity Centre Of India (COMMUNIST),7148,31,7179,0.46,S1226
7,AYAZ ALI,Independent,7074,22,7096,0.45,S1226
8,ENG. ARJUN PARIHAR,Independent,3823,8,3831,0.25,S1226
9,BASANT GEHLOT,Jan Sangh Party,3663,13,3676,0.24,S1226
10,RAVI SIRWAIYA,Independent,2615,6,2621,0.17,S1226
11,MUDIT CHAURASIA,Independent,2601,8,2609,0.17,S1226
12,PARMANAND TOLANI,Independent,2399,4,2403,0.15,S1226
13,DESH BHAKT ANKIT GUPTA,Independent,1957,12,1969,0.13,S1226
14,ADVOCATE PANKAJ GUPTE,Independent,1652,8,1660,0.11,S1226
15,NOTA,None of the Above,218355,319,218674,14,S1226
1,HANUMAN BENIWAL,Rashtriya Loktantrik Party,591460,5495,596955,48.2,S2014
2,JYOTI MIRDHA,Bharatiya Janata Party,550304,4426,554730,44.79,S2014
3,DR ASHOK CHOUDHARY,Abhinav Rajasthan Party,26251,43,26294,2.12,S2014
4,DR. GAJENDRA SINGH RATHORE,Bahujan Samaj Party,23551,457,24008,1.94,S2014
5,RAJKUMAR JAT,Independent,8219,13,8232,0.66,S2014
6,HARI RAM,Independent,7610,16,7626,0.62,S2014
7,PREMRAJ KHARDIYA,Independent,4504,8,4512,0.36,S2014
8,AMEEN KHAN,Independent,4439,24,4463,0.36,S2014
9,HANUMAN SINGH KALVI,Rashtriya Janshakti Party (Secular),2862,20,2882,0.23,S2014
10,NOTA,None of the Above,8711,60,8771,0.71,S2014
1,DURGADAS (D. D.) UIKEY,Bharatiya Janata Party,846696,1540,848236,60.76,S1229
2,RAMU TEKAM,Indian National Congress,467810,665,468475,33.56,S1229
3,ARJUN ASHOK BHALAVI,Bahujan Samaj Party,26559,38,26597,1.91,S1229
4,ANIL UIKEY,Bharat Adivasi Party,10552,24,10576,0.76,S1229
5,BHURELAL CHOTELAL BETHEKAR,Independent,7800,11,7811,0.56,S1229
6,BHAGCHARAN WARKADE,Independent,5957,11,5968,0.43,S1229
7,SUNER UIKEY,Gondvana Gantantra Party,4172,14,4186,0.3,S1229
8,BARSKAR SUBHASH KORAKU,Swatantra Kisan Party,3831,18,3849,0.28,S1229
9,NOTA,None of the Above,20309,13,20322,1.46,S1229
1,PHANI BHUSAN CHOUDHURY,Asom Gana Parishad,853642,6471,860113,51.02,S033
2,DEEP BAYAN,Indian National Congress,635411,2351,637762,37.83,S033
3,MANORANJAN TALUKDAR,Communist Party of India  (Marxist),95020,1118,96138,5.7,S033
4,ABUL KALAM AZAD,All India Trinamool Congress,16359,73,16432,0.97,S033
5,DEWAN MOHIBUL ISLAM,Independent,9930,11,9941,0.59,S033
6,SAMEJ UDDIN,Bodoland Peoples Front,9515,177,9692,0.57,S033
7,DULU AHMED,Independent,9275,63,9338,0.55,S033
8,MATIAR RAHMAN,Independent,7920,15,7935,0.47,S033
9,JAGANNATH RAY,Independent,5474,74,5548,0.33,S033
10,SHAJAHAN ALI KHAN,Voters Party  International,4441,7,4448,0.26,S033
11,AYNAL HAQUE,Independent,3174,18,3192,0.19,S033
12,CHITRALEKHA DAS,Socialist Unity Centre Of India (COMMUNIST),3060,71,3131,0.19,S033
13,AMZAD ALI,Republican Party of India (Athawale),2657,22,2679,0.16,S033
14,ABUBAKKAR SIDDIQUE,Rashtriya Ulama Council,2463,14,2477,0.15,S033
15,NOTA,None of the Above,16888,229,17117,1.02,S033
1,BRIJMOHAN AGRAWAL,Bharatiya Janata Party,1047447,2904,1050351,66.19,S268
2,VIKAS UPADHYAY,Indian National Congress,473656,1410,475066,29.94,S268
3,MAMTA RANI SAHU,Bahujan Samaj Party,9201,98,9299,0.59,S268
4,SAVITA SHAILENDRA BANJARE,Shakti Sena (Bharat Desh),8765,3,8768,0.55,S268
5,RADHESHWARI GAIKWAD,Independent,4629,1,4630,0.29,S268
6,SURESH KUMAR NETAM,Hamar Raj Party,3492,7,3499,0.22,S268
7,ANIL MAHOBIA,Right to Recall Party,2914,2,2916,0.18,S268
8,ENGI. LAL BAHADUR YADAV,Gondvana Gantantra Party,2859,6,2865,0.18,S268
9,RAMKRISHNA VERMA,Independent,2182,3,2185,0.14,S268
10,YAKUB KHAN,Independent,2054,0,2054,0.13,S268
11,VISHWAJIT HARODE,Socialist Unity Centre Of India (COMMUNIST),1920,0,1920,0.12,S268
12,AMARNATH CHANDRAKAR,Independent,1608,0,1608,0.1,S268
13,LAKHAMOO RAM TANDON,Rashtriya Jansabha Party,1347,4,1351,0.09,S268
14,YASHUTOSH LAHARE,Ambedkarite Party of India,1312,0,1312,0.08,S268
15,RAJESH DHRUV,Independent,1187,6,1193,0.08,S268
16,BODHAN LAL FARIKAR,Independent,1059,0,1059,0.07,S268
17,DAYA SHANKER NISHAD,Bhartiya Shakti Chetna Party,1051,11,1062,0.07,S268
18,PILARAM ANANT,Sunder Samaj Party,1033,3,1036,0.07,S268
19,ROHIT KUMAR PATIL,Independent,960,0,960,0.06,S268
20,HIRA NAND NAGWANI (ASHOK BHAIYA),Republican Party of India (A),958,2,960,0.06,S268
21,BHANJAN JANGADE (ADHIWAKTA),Bharatiya Bahujan Congress,818,3,821,0.05,S268
22,MO. AMIN,Bhrashtachar Mukti Morcha,765,1,766,0.05,S268
23,MANOJ VERMA,Independent,723,1,724,0.05,S268
24,PITAMBAR JANGDE,Aazad Samaj Party (Kanshi Ram),701,4,705,0.04,S268
25,ASHISH KUMAR TIWARI,Aap Sabki Apni Party,525,3,528,0.03,S268
26,ENGI. BHANU PRATAP TANDE,Independent,500,3,503,0.03,S268
27,MO. IMRAN KHAN,Independent,466,1,467,0.03,S268
28,NEERAJ SAINI PUJARI,Dhoom Sena,434,0,434,0.03,S268
29,SUDHANSHU BHUSHAN,Independent,413,1,414,0.03,S268
30,RAMPRASAD PRAJAPATI,Independent,391,0,391,0.02,S268
31,PRAVIN JAIN,Independent,369,0,369,0.02,S268
32,VINAYAK DHAMGAYE,Independent,349,0,349,0.02,S268
33,NANDNI NAYAK,Independent,336,1,337,0.02,S268
34,PRAVISHANT SALOMAN,Independent,310,0,310,0.02,S268
35,SAYED IRSHAD,Independent,295,0,295,0.02,S268
36,DR. OMPRAKASH SAHU,Independent,291,3,294,0.02,S268
37,MO. NASIR,Independent,254,0,254,0.02,S268
38,NURI KHAN,Independent,252,0,252,0.02,S268
39,NOTA,None of the Above,4414,34,4448,0.28,S268
1,RAM PRASAD CHAUDHARY,Samajwadi Party,523487,3518,527005,48.67,S2461
2,HARISH CHANDRA ALIAS HARISH DWIVEDI,Bharatiya Janata Party,424604,1407,426011,39.34,S2461
3,LAVKUSH PATEL,Bahujan Samaj Party,102818,483,103301,9.54,S2461
4,PANKAJ DUBEY,Log Party,4624,3,4627,0.43,S2461
5,PREM KUMAR,Moulik Adhikar Party,3607,4,3611,0.33,S2461
6,HAFIZ ALI,All India Forward Bloc,2985,3,2988,0.28,S2461
7,RAM KARAN GAUTAM,Independent,2640,5,2645,0.24,S2461
8,PRAMOD KUMAR,Independent,2554,3,2557,0.24,S2461
9,SHAILENDRA KUMAR,Bharat Mahaparivar Party,2361,3,2364,0.22,S2461
10,NOTA,None of the Above,7742,19,7761,0.72,S2461
1,SHIVMANGAL SINGH TOMAR,Bharatiya Janata Party,513136,2341,515477,43.41,S121
2,NEETU SATYAPAL SINGH SIKARWAR,Indian National Congress,461808,1139,462947,38.99,S121
3,RAMESH GARG,Bahujan Samaj Party,179492,177,179669,15.13,S121
4,NEERAJ CHANDSORIYA,Aazad Samaj Party (Kanshi Ram),7534,10,7544,0.64,S121
5,RAJENDRA PRASAD KUSHWAH,Independent,2392,10,2402,0.2,S121
6,ER. SURAJ KUSHWAH,Independent,2279,6,2285,0.19,S121
7,RAMNIWASH,Independent,1970,3,1973,0.17,S121
8,RAM SUNDER SHARMA,Independent,1762,5,1767,0.15,S121
9,RAMSEVAK SAKHWAR,Independent,1630,2,1632,0.14,S121
10,HARIKANTH,Independent,1623,0,1623,0.14,S121
11,RAJKUMARI,Independent,1435,6,1441,0.12,S121
12,ANOOP NAGAR,Independent,1308,9,1317,0.11,S121
13,RAJENDRA SINGH GURJER,Independent,1199,11,1210,0.1,S121
14,PIYUSH BRAJESH RAJORIYA,Independent,572,3,575,0.05,S121
15,PRABHU JATAV,Independent,547,8,555,0.05,S121
16,NOTA,None of the Above,4899,15,4914,0.41,S121
1,AGA SYED RUHULLAH MEHDI,Jammu & Kashmir National Conference,355294,1572,356866,52.85,U082
2,WAHEED UR REHMAN PARA,Jammu & Kashmir Peoples Democratic Party,167666,784,168450,24.95,U082
3,MOHAMMAD ASHRAF MIR,Jammu and Kashmir Apni Party,65494,460,65954,9.77,U082
4,AMIR AHMAD BHAT,Democratic Progressive Azad Party,15061,43,15104,2.24,U082
5,SHEEBAN ASHAI,Independent,13063,8,13071,1.94,U082
6,SAYIM MUSTAFA,Independent,8831,49,8880,1.32,U082
7,JIBRAN FIRDOUS DAR,Independent,5431,67,5498,0.81,U082
8,JAHANGIR AHMAD SHEIKH,Independent,4412,10,4422,0.65,U082
9,SAJAD AHMAD DAR,Independent,3755,9,3764,0.56,U082
10,HAKIKAT SINGH,Jammu & Kashmir National Panthers Party (Bhim),3732,46,3778,0.56,U082
11,RUBINA AKHTER,National Loktantrik Party,2855,21,2876,0.43,U082
12,WASEEM HASSAN SHEIKH,Independent,2838,17,2855,0.42,U082
13,RIYAZ AHMAD BHAT,Independent,2791,1,2792,0.41,U082
14,FAYAZ AHMAD BUTT,Independent,2221,6,2227,0.33,U082
15,SHAHNAZ HUSSAIN SHAH,Independent,2196,7,2203,0.33,U082
16,MOHD YOUSUF BHAT,Gana Suraksha Party,1880,18,1898,0.28,U082
17,WAHEEDA TABASUM SHAH,Independent,1594,12,1606,0.24,U082
18,NISAR AHMAD AHANGAR,Independent,1115,9,1124,0.17,U082
19,MIRZA SAJAD HUSSAIN BEIGH,Independent,1049,15,1064,0.16,U082
20,GHULAM MOHAMMAD WANI,Independent,1028,12,1040,0.15,U082
21,AMIN DAR,Independent,989,7,996,0.15,U082
22,JAVEED AHMAD WANI,Independent,928,4,932,0.14,U082
23,YOUNIS AHMAD MIR,Bharat Jodo Party,913,12,925,0.14,U082
24,DR QAZI ASHRAF,Independent,910,9,919,0.14,U082
25,NOTA,None of the Above,5887,111,5998,0.89,U082
1,GURUMOORTHY MADDILA,Yuvajana Sramika Rythu Congress Party,626702,5526,632228,45.73,S0123
2,VARA PRASAD RAO VELAGAPALLI,Bharatiya Janata Party,608494,9165,617659,44.67,S0123
3,CHINTA MOHAN,Indian National Congress,63790,1733,65523,4.74,S0123
4,PENUMURU. GURAPPA,Bahujan Samaj Party,10300,206,10506,0.76,S0123
5,KATTAMANCHI. PRABHAKAR,Independent,5796,6,5802,0.42,S0123
6,M UMADEVI,Janata Congress,5387,38,5425,0.39,S0123
7,ALLAM.RAJA,Independent,4948,22,4970,0.36,S0123
8,VIJAY KUMAR G.SRKR,Liberation Congress Party,4108,194,4302,0.31,S0123
9,ANJAIAH.P,Republican Party of India (A),3657,9,3666,0.27,S0123
10,V.C. NAVEEN GUPTA,Independent,1723,8,1731,0.13,S0123
11,A. VARAPRASAD,Jatiya Jana Sena Party,1668,30,1698,0.12,S0123
12,SYAMDHAN KURAPATI,Aihra National Party,1567,1,1568,0.11,S0123
13,C. PUNYAMURTHY,United Republican Party of India,1511,4,1515,0.11,S0123
14,KARRA SIVA,Pyramid Party of India,1501,9,1510,0.11,S0123
15,VELURU. THEJOVATHI,Samajwadi Party,1362,27,1389,0.1,S0123
16,C. DAVID,Indian Believers Party (IBP),1237,2,1239,0.09,S0123
17,K. JEEVARATHNAM,Independent,1203,1,1204,0.09,S0123
18,DASARI. GOWTHAM,Independent,1077,10,1087,0.08,S0123
19,VIJAYA KUMAR.G,Independent,797,4,801,0.06,S0123
20,A. MADHU,Jai Hindustan Party,711,0,711,0.05,S0123
21,B. BHARANI BAS,Ambedkar National Congress,688,0,688,0.05,S0123
22,Y. MAHESH,Independent,615,7,622,0.04,S0123
23,PRASAD PATIBANDLA,Independent,607,1,608,0.04,S0123
24,NOTA,None of the Above,15909,209,16118,1.17,S0123
1,M. MALLESH BABU,Janata Dal  (Secular),689185,2296,691481,51.02,S1028
2,K V GOWTHAM,Indian National Congress,618700,1393,620093,45.76,S1028
3,SUMAN H N,Independent,6484,3,6487,0.48,S1028
4,HOLUR SRINIVASA,Independent,6159,4,6163,0.45,S1028
5,S B SURESHA,Bahujan Samaj Party,4688,44,4732,0.35,S1028
6,K R DEVARAJA,Delhi Janta Party,4588,9,4597,0.34,S1028
7,DR M. VENKATASWAMY,Independent,3336,18,3354,0.25,S1028
8,R RANJITHKUMAR,Independent,2116,2,2118,0.16,S1028
9,S N NARAYANASWAMY V,Independent,1971,14,1985,0.15,S1028
10,D GOPALAKRISHNA,Socialist Party (India),1661,8,1669,0.12,S1028
11,DEVARAJA A ALUSURUDINNE,Uttama Prajaakeeya Party,1343,11,1354,0.1,S1028
12,M S BADARINARAYANA,Independent,1104,12,1116,0.08,S1028
13,MAHESH A V,Karnataka Rashtra Samithi,1035,30,1065,0.08,S1028
14,THIMMARAYAPPA,Republican Party of India (Karnataka),856,8,864,0.06,S1028
15,R RAJENDRA,Independent,750,1,751,0.06,S1028
16,M MUNIGANGAPPA,Independent,595,9,604,0.04,S1028
17,M  C HALLI VENU,Viduthalai Chiruthaigal Katchi,514,7,521,0.04,S1028
18,KRISHNAIAH N,Independent,438,5,443,0.03,S1028
19,NOTA,None of the Above,5798,33,5831,0.43,S1028
1,GAIKWAD VARSHA EKNATH,Indian National Congress,444098,1447,445545,48.93,S1329
2,ADV UJWAL NIKAM,Bharatiya Janata Party,427387,1644,429031,47.12,S1329
3,SANTOSH GANPAT AMBULGE,Vanchit Bahujan  Aaghadi,8233,55,8288,0.91,S1329
4,AYYUB AMIN HUNGUND,Bahujan Samaj Party,3229,14,3243,0.36,S1329
5,ANSON THOMAS,People's Party of India(secular),2207,4,2211,0.24,S1329
6,RAMZAN ALI CHAUDHARY,All India Majlis-E-Ittehadul Muslimeen,1521,10,1531,0.17,S1329
7,AJAZ MOHAMMAD SAFI KHAN,Independent,1041,0,1041,0.11,S1329
8,HAYATULAH ABDULAH SHAIKH,Akhil Bharatiya Muslim League (Secular),818,3,821,0.09,S1329
9,NAZMAKHATHUN MOHAMMED ZAFAR KHAN,Independent,730,2,732,0.08,S1329
10,SHANTARAM S DIGHE,Independent,723,10,733,0.08,S1329
11,NARENDRA MISHRA,Independent,706,2,708,0.08,S1329
12,ADV ASIF ALI SIDDIQUIE,Independent,681,2,683,0.08,S1329
13,HARSHADA BABURAV JADHAV,Maharashtra Vikas Aghadi,673,17,690,0.08,S1329
14,RAMA ARUN SABLE,Independent,626,10,636,0.07,S1329
15,SANDEEP BHAU RAMCHANDRA JADHAV,Independent,619,4,623,0.07,S1329
16,DR GAFFAR IBRAHIM SAYED,Independent,584,2,586,0.06,S1329
17,ADV UTTAMKUMAR NAKUL SAJANI SAHU,Independent,554,4,558,0.06,S1329
18,KHAN ABBAS AHMED,Bahujan Maha Party,427,1,428,0.05,S1329
19,MUSHTAQUE HAIDER SHAIKH,Independent,405,0,405,0.04,S1329
20,DR ADV YASHWANT RAMBHAU KASBE,Bhartiya Jan Vikas Aaghadi,385,6,391,0.04,S1329
21,KURBAN SHAHADAT HUSAIN,Rashtriya Ulama Council,366,1,367,0.04,S1329
22,ABDUL TAHIR ADVOCATE BABLU RAJNIKANT,Independent,355,0,355,0.04,S1329
23,SHAUKAT ABDUL RAFIQ KHAN,Insaniyat Party,341,4,345,0.04,S1329
24,RAJESH MOHAN LOKHANDE,Independent,282,7,289,0.03,S1329
25,YUNUSALI RASHID MULLA,Independent,220,0,220,0.02,S1329
26,ADV FEROZ SHAIKH,Independent,180,0,180,0.02,S1329
27,MUZAFAR ALI SHAIKH,Independent,173,0,173,0.02,S1329
28,NOTA,None of the Above,9665,84,9749,1.07,S1329
1,PATHAN YUSUF,All India Trinamool Congress,523630,886,524516,37.88,S2510
2,ADHIR RANJAN CHOWDHURY,Indian National Congress,438171,1323,439494,31.74,S2510
3,DR. NIRMAL KUMAR SAHA,Bharatiya Janata Party,370370,1515,371885,26.86,S2510
4,SAMIRAN DAS,Independent,18526,1,18527,1.34,S2510
5,SWAPAN KUMAR MANDAL,Independent,6394,2,6396,0.46,S2510
6,SANTOSH BISWAS,Bahujan Samaj Party,4219,19,4238,0.31,S2510
7,BISWAMVOIR KALITA,Independent,3060,2,3062,0.22,S2510
8,SOMNATH PAUL,All India Arya Mahasabha,2250,0,2250,0.16,S2510
9,RUNA LAILA,Social Democratic Party Of India,1569,2,1571,0.11,S2510
10,ABHIJIT MANDAL,Socialist Unity Centre Of India (COMMUNIST),1410,8,1418,0.1,S2510
11,ASHIS DAS,Independent,1106,4,1110,0.08,S2510
12,ADHIR SWARNAKAR,Independent,851,5,856,0.06,S2510
13,AJIT KUMAR MANDAL,Independent,745,4,749,0.05,S2510
14,MANIK KUMAR DAS,Jai Prakash Janata Dal,729,0,729,0.05,S2510
15,AABDUSA SATTAR SEKH,Indian National Socialistic Action Forces,477,7,484,0.03,S2510
16,NOTA,None of the Above,7474,11,7485,0.54,S2510
1,LOVELY ANAND,Janata Dal  (United),475709,903,476612,45.15,S044
2,RITU JAISWAL,Rashtriya Janata Dal,445482,1987,447469,42.39,S044
3,AKHILESHWAR SHRIVAISHANV,Independent,29014,80,29094,2.76,S044
4,KANHAIYA KUMAR,Independent,20585,7,20592,1.95,S044
5,RANA RANJIT,All India Majlis-E-Ittehadul Muslimeen,11947,32,11979,1.13,S044
6,SUDHIR KUMAR SINGH,Viro Ke Vir Indian Party,9096,6,9102,0.86,S044
7,VIJENDRA THAKUR,Bahujan Samaj Party,8865,23,8888,0.84,S044
8,UPENDRA SAHANI,Rashtriya Jansambhavna Party,6332,6,6338,0.6,S044
9,MAMTA KUMARI,Samata Party,5431,4,5435,0.51,S044
10,MOHAMMAD MAHTAB ALAM,Samaj Shakti Party,4867,4,4871,0.46,S044
11,JAGDISH PRASAD,Bajjikanchal Vikas Party,2950,5,2955,0.28,S044
12,DILIP KUMAR MISHRA,Prabal Bharat Party,2097,2,2099,0.2,S044
13,NOTA,None of the Above,30130,38,30168,2.86,S044
1,TATKARE SUNIL DATTATREY,Nationalist Congress Party,506529,1823,508352,50.17,S1332
2,ANANT GEETE,Shiv Sena (Uddhav Balasaheb Thackrey),423137,2431,425568,42,S1332
3,KUMUDINI RAVINDRA CHAVAN,Vanchit Bahujan  Aaghadi,19500,118,19618,1.94,S1332
4,SHRINIVAS SATYANARAYAN MATTAPARTI,Independent,9379,15,9394,0.93,S1332
5,AMIT SHRIPAL KAWADE,Independent,5603,31,5634,0.56,S1332
6,ANANT BALOJI GITE,Independent,3485,30,3515,0.35,S1332
7,NITIN JAGANNATH MAYEKAR,Independent,2548,12,2560,0.25,S1332
8,CHAULE PANDURANG DAMODAR,Independent,2394,23,2417,0.24,S1332
9,ANANT PADMA GITE,Independent,2001,39,2040,0.2,S1332
10,COL PRAKASHRAO CHAVAN,Bharatheeya Jawan Kisan Party,1863,76,1939,0.19,S1332
11,KOLI MANGESH PADMAKAR,Independent,1797,23,1820,0.18,S1332
12,ADV AJAY UPADHYE,Independent,1756,39,1795,0.18,S1332
13,ANJANI ASHWIN KELKAR,Independent,1325,25,1350,0.13,S1332
14,NOTA,None of the Above,27188,82,27270,2.69,S1332
1,KALYAN BANERJEE,All India Trinamool Congress,671865,2105,673970,45.65,S2527
2,KABIR SHANKAR BOSE,Bharatiya Janata Party,497720,1420,499140,33.8,S2527
3,DIPSITA DHAR,Communist Party of India  (Marxist),238131,1015,239146,16.2,S2527
4,SAHARIAR MULLICK (BAPI),All India Secular Front,25659,18,25677,1.74,S2527
5,SUNDAR PATRA,Independent,9897,5,9902,0.67,S2527
6,SASANKA CHAKRABORTY,Independent,3933,5,3938,0.27,S2527
7,SUPRIYA BISWAS,Bahujan Samaj Party,3572,17,3589,0.24,S2527
8,KALYAN PAUL,Independent,1749,9,1758,0.12,S2527
9,PRADYUT CHOWDHURI,Socialist Unity Centre Of India (COMMUNIST),1671,9,1680,0.11,S2527
10,KALYAN SAMANTA,Independent,1421,19,1440,0.1,S2527
11,SARKAR MANGAL,Bahujan Maha Party,1256,2,1258,0.09,S2527
12,NOTA,None of the Above,14964,70,15034,1.02,S2527
1,VE VAITHILINGAM,Indian National Congress,424292,1713,426005,52.73,U071
2,A NAMASSIVAYAM,Bharatiya Janata Party,288050,1439,289489,35.83,U071
3,R MENAGA,Naam Tamilar Katchi,39545,58,39603,4.9,U071
4,G THAMIZHVENDAN,All India Anna Dravida Munnetra Kazhagam,25059,106,25165,3.11,U071
5,P SANKARAN,Socialist Unity Centre Of India (COMMUNIST),2057,9,2066,0.26,U071
6,ARADADI POSIYYA,Independent,1540,6,1546,0.19,U071
7,D ALANGARAVELU,Bahujan Samaj Party,1534,6,1540,0.19,U071
8,K KISHORKUMAR,Independent,1240,6,1246,0.15,U071
9,KOLLANJIAPPAN,Independent,1198,1,1199,0.15,U071
10,M MANIKANDAN,Independent,1130,3,1133,0.14,U071
11,M KRISHNAMURTHY,Independent,1052,19,1071,0.13,U071
12,K PRABHU DEVAN,United Republican Party of India,981,8,989,0.12,U071
13,S BAKTHAVATCHALAM,Independent,923,1,924,0.11,U071
14,S SATHISH KUMAR,Independent,842,4,846,0.1,U071
15,COUTTANE ALIAS DHIVANEEDHE,Independent,819,3,822,0.1,U071
16,E ANANTHAVEL,Independent,771,5,776,0.1,U071
17,S KALA,Independent,593,33,626,0.08,U071
18,P RAJAN,Independent,545,2,547,0.07,U071
19,NIRMALA G,Independent,474,1,475,0.06,U071
20,K ARUNACHALAM,Independent,403,2,405,0.05,U071
21,K RAMADASS,Independent,368,4,372,0.05,U071
22,R RAJA,Independent,326,5,331,0.04,U071
23,D RAVINDIRAN,Independent,305,2,307,0.04,U071
24,S MASCO,Independent,248,6,254,0.03,U071
25,V P MANICKAM,Independent,242,2,244,0.03,U071
26,M MURUGAN,Independent,196,0,196,0.02,U071
27,NOTA,None of the Above,9756,7,9763,1.21,U071
1,SANJAY DINA PATIL,Shiv Sena (Uddhav Balasaheb Thackrey),448604,2333,450937,48.67,S1328
2,MIHIR CHANDRAKANT KOTECHA,Bharatiya Janata Party,419589,1487,421076,45.45,S1328
3,DAULAT KADAR KHAN,Vanchit Bahujan  Aaghadi,14571,86,14657,1.58,S1328
4,NANDESH VITHAL UMAP,Bahujan Samaj Party,8217,101,8318,0.9,S1328
5,DR. SUSHMA MAURYA,Independent,2886,5,2891,0.31,S1328
6,SANJAY B. PATIL,National People's Party,2757,7,2764,0.3,S1328
7,SANJU MARUTI PAWAR,Maharashtra Vikas Aghadi,2555,27,2582,0.28,S1328
8,PROF. DR. PRASHANT GANGAWANE,Desh Janhit Party,2338,35,2373,0.26,S1328
9,PREM RAMAPATI GUPTA,Independent,1598,3,1601,0.17,S1328
10,MOHAMMED AHMED SHAIKH,Independent,1289,5,1294,0.14,S1328
11,MOHAMMAD ARMAN MOHAMMAD WASI KHAN,Rashtriya Janhit Sangharsh Party,1085,5,1090,0.12,S1328
12,VIDYA NAIK,Independent,974,5,979,0.11,S1328
13,BHOPINDER SINGH SAINI,Viro Ke Vir Indian Party,941,5,946,0.1,S1328
14,BANSODE DILIP,Independent,831,7,838,0.09,S1328
15,BHAWANI H. CHOUDHARY,Sardar Vallabhbhai Patel Party,742,4,746,0.08,S1328
16,DATTATRAY ARJUN UTEKAR,Bharatheeya Jawan Kisan Party,707,4,711,0.08,S1328
17,COMRADE SURENDRA SIBAG,All India Forward Bloc,675,3,678,0.07,S1328
18,SHAHAJI  NANAI THORAT,Independent,648,2,650,0.07,S1328
19,SANJAY SAOJI DESHPANDE,Republican Party of India,641,0,641,0.07,S1328
20,SANJAY PATIL,Independent,520,4,524,0.06,S1328
21,NOTA,None of the Above,10088,85,10173,1.1,S1328
1,DR. SHARMILA SARKAR,All India Trinamool Congress,717881,2421,720302,48.11,S2538
2,ASIM KUMAR SARKAR,Bharatiya Janata Party,557943,1787,559730,37.38,S2538
3,NIRAB KHAN,Communist Party of India  (Marxist),176358,541,176899,11.81,S2538
4,NIRMAL MAJHI,Socialist Unity Centre Of India (COMMUNIST),10964,12,10976,0.73,S2538
5,MUKUL BISWAS,Bahujan Samaj Party,7610,21,7631,0.51,S2538
6,SHARMILA SARKAR,Independent,4875,18,4893,0.33,S2538
7,SAJAL KUMAR DE,Communist Party of India  (Marxist-Leninist)  (Liberation),4163,19,4182,0.28,S2538
8,NOTA,None of the Above,12654,43,12697,0.85,S2538
1,K E PRAKASH,Dravida Munnetra Kazhagam,558849,3490,562339,51.43,S2217
2,ASHOK KUMAR,All India Anna Dravida Munnetra Kazhagam,323751,2022,325773,29.79,S2217
3,KARMEGAN M,Naam Tamilar Katchi,82332,464,82796,7.57,S2217
4,P VIJAYAKUMAR,Tamil Maanila Congress  (Moopanar),77319,592,77911,7.13,S2217
5,P ESWARAN,Bahujan Samaj Party,5161,62,5223,0.48,S2217
6,T V R AMIRTHALINGAM,Independent,4118,31,4149,0.38,S2217
7,KEERTHANA M,Independent,3775,24,3799,0.35,S2217
8,J GOPALAKRISHNAN,Independent,1949,6,1955,0.18,S2217
9,S ANANTHI,Independent,1683,3,1686,0.15,S2217
10,PRASATH CHITRARASU,Independent,1629,11,1640,0.15,S2217
11,RAVICHANDRAN L,Independent,1378,2,1380,0.13,S2217
12,P RAJENDRAN,Independent,973,3,976,0.09,S2217
13,P KUPPUSAMY,Ulzaipali Makkal Katchy,945,5,950,0.09,S2217
14,M SHANMUGAM,Independent,768,4,772,0.07,S2217
15,R KUMARESAN,Independent,744,7,751,0.07,S2217
16,N ASHOK KUMAR,Independent,689,1,690,0.06,S2217
17,DHANALAKSHMI V,Naadaalum Makkal Katchi,675,4,679,0.06,S2217
18,A T MUNUSAMY,Samaniya Makkal Nala Katchi,611,5,616,0.06,S2217
19,K MAATHAN,Ganasangam Party of India,609,9,618,0.06,S2217
20,B DHARMARAJ,Anti Corruption Dynamic Party,597,4,601,0.05,S2217
21,ARUMUGA AC KANNAN,Independent,547,2,549,0.05,S2217
22,M SABARINATHAN,Independent,525,6,531,0.05,S2217
23,R DHANDAPANI,Veerath Thiyagi Viswanathadoss Thozhilalarkal Katchi,502,2,504,0.05,S2217
24,R KUMAR,Anna Puratchi Thalaivar Amma Dravida Munnetra Kazhagam,424,8,432,0.04,S2217
25,R.MINNALMURUGESH,Independent,413,2,415,0.04,S2217
26,K K VADUGANATHAN,Independent,398,1,399,0.04,S2217
27,G MYLSAMY,Independent,301,0,301,0.03,S2217
28,MYLVAKANAN D -,Independent,276,3,279,0.03,S2217
29,M PRABAKARAN,Independent,274,2,276,0.03,S2217
30,NARENDRANATH,Independent,272,0,272,0.02,S2217
31,K SENTHIL KUMAR,Independent,177,1,178,0.02,S2217
32,NOTA,None of the Above,13742,241,13983,1.28,S2217
1,DHARMENDRA YADAV,Samajwadi Party,504837,3402,508239,48.2,S2469
2,DINESH LAL YADAV “NIRAHUA”,Bharatiya Janata Party,345725,1479,347204,32.93,S2469
3,MASHHOD SABEEHA ANSARI,Bahujan Samaj Party,179189,650,179839,17.05,S2469
4,RAVINDRA NATH SHARMA,Moulik Adhikar Party,3038,4,3042,0.29,S2469
5,PARAS YADAV,Jan Raajya Party,2489,2,2491,0.24,S2469
6,SHASHIDHAR,Independent,2227,5,2232,0.21,S2469
7,MAHENDRA NATH YADAV,Moolniwasi Samaj Party,1904,1,1905,0.18,S2469
8,VIJAY KUMAR,Independent,1733,2,1735,0.16,S2469
9,PANKAJ KUMAR YADAV,Independent,1595,4,1599,0.15,S2469
10,NOTA,None of the Above,6211,23,6234,0.59,S2469
1,BHAGIRATH CHOUDHARY,Bharatiya Janata Party,741151,6311,747462,62.23,S2013
2,RAMCHANDRA CHOUDHARY,Indian National Congress,413685,3786,417471,34.76,S2013
3,RAMDEV,Bahujan Samaj Party,4896,48,4944,0.41,S2013
4,SURENDRA SINGH RANAVAT,Independent,4348,25,4373,0.36,S2013
5,MUKESH GENA,Bharatiya Yuva Jan Ekta Party,3187,9,3196,0.27,S2013
6,JITENDRA BOYAT,Aazad Samaj Party (Kanshi Ram),2608,25,2633,0.22,S2013
7,SATYANARAYAN MALI,Independent,2409,11,2420,0.2,S2013
8,VISHRAM BABU,Independent,1517,7,1524,0.13,S2013
9,SHABUDADIN,National Future Party,1190,7,1197,0.1,S2013
10,YUSUF,Independent,988,12,1000,0.08,S2013
11,PREM LATA,Independent,988,167,1155,0.1,S2013
12,BHAWARLAL SONI,Independent,868,70,938,0.08,S2013
13,RAMLAL,Akhil Bhartiya Aamjan Party,807,11,818,0.07,S2013
14,DAYA MOHAN GARG,Independent,644,2,646,0.05,S2013
15,NOTA,None of the Above,11290,112,11402,0.95,S2013
1,AMRITPAL SINGH,Independent,402600,1830,404430,38.62,S193
2,KULBIR SINGH ZIRA,Indian National Congress,206286,1024,207310,19.8,S193
3,LALJIT SINGH BHULLAR,Aam Aadmi Party,194160,676,194836,18.61,S193
4,VIRSA SINGH VALTOHA,Shiromani Akali Dal,86291,125,86416,8.25,S193
5,MANJIT SINGH MANNA,Bharatiya Janata Party,85810,563,86373,8.25,S193
6,PARAMJIT SINGH,Independent,12522,3,12525,1.2,S193
7,CHAIN SINGH BAINKA,Aas Punjab Party,6728,11,6739,0.64,S193
8,SATNAM SINGH,Bahujan Samaj Party,5021,45,5066,0.48,S193
9,SARABJIT SINGH,Independent,4835,1,4836,0.46,S193
10,GURDIAL SINGH,Communist Party of India,3945,7,3952,0.38,S193
11,ANOKH SINGH KATWAL,Independent,2766,3,2769,0.26,S193
12,GURPREET SINGH,Independent,2609,0,2609,0.25,S193
13,AJIT SINGH,Independent,2528,7,2535,0.24,S193
14,ARUN KUMAR,Independent,2522,3,2525,0.24,S193
15,SURJIT SINGH BHIKHIWIND,Independent,2367,4,2371,0.23,S193
16,KAWALJIT SINGH,Independent,2290,4,2294,0.22,S193
17,HARJINDER SINGH,Independent,1969,1,1970,0.19,S193
18,KANWALJIT SINGH,Independent,1895,6,1901,0.18,S193
19,PARMINDER SINGH,Independent,1802,1,1803,0.17,S193
20,JASWANT SINGH SOHAL,Independent,1637,2,1639,0.16,S193
21,LAKHBIR SINGH,Independent,1420,1,1421,0.14,S193
22,VIKRAMJIT SINGH,Independent,1417,3,1420,0.14,S193
23,VIJAY KUMAR,Independent,1388,0,1388,0.13,S193
24,DILBAGH SINGH,All India Mazdoor Party (Rangreta),1363,11,1374,0.13,S193
25,SIMRANJEET SINGH,Independent,1338,3,1341,0.13,S193
26,MAHINDER SINGH HAMIRA,Independent,1044,2,1046,0.1,S193
27,NAVEEN KUMAR SHARMA,Sanjhi Virasat Party,823,1,824,0.08,S193
28,NOTA,None of the Above,3420,32,3452,0.33,S193
1,SUDHAKAR SINGH,Rashtriya Janata Dal,435062,3283,438345,40.82,S0433
2,MITHILESH TIWARI,Bharatiya Janata Party,405795,2459,408254,38.02,S0433
3,ANIL KUMAR,Bahujan Samaj Party,114312,402,114714,10.68,S0433
4,ANAND MISHRA S/O- PARAM HANS MISHRA,Independent,46527,882,47409,4.42,S0433
5,DADAN YADAV,Independent,15653,183,15836,1.47,S0433
6,SUDHAKAR MISHRA,Independent,12742,7,12749,1.19,S0433
7,SUNIL KUMAR DUBY,Independent,7757,2,7759,0.72,S0433
8,RAM SWAROOP CHAUHAN,Independent,5506,10,5516,0.51,S0433
9,RAJU SINGH,Bahujan Mukti Party,4322,17,4339,0.4,S0433
10,AANAND MISRA S/O MADAN KUMAR MISRA,Independent,2697,137,2834,0.26,S0433
11,BHAGWAN SINGH YADAV,Independent,2045,8,2053,0.19,S0433
12,NIRANJAN KUMAR RAY,Independent,1667,2,1669,0.16,S0433
13,HEM LATA,Jagrook Janta Party,1554,16,1570,0.15,S0433
14,AKHILESH KUMAR PANDEY,Independent,1089,6,1095,0.1,S0433
15,NOTA,None of the Above,9572,45,9617,0.9,S0433
1,GAJENDRA SINGH SHEKHAWAT,Bharatiya Janata Party,722978,7078,730056,52.76,S2016
2,KARAN SINGH UCHIYARDA,Indian National Congress,608228,6151,614379,44.4,S2016
3,SUNIL KUMAR PAREEK,Independent,7424,5,7429,0.54,S2016
4,MANJU MEGHWAL,Bahujan Samaj Party,6347,48,6395,0.46,S2016
5,ANANDARAM URF ANAND CHAUHAN,Aazad Samaj Party (Kanshi Ram),3662,18,3680,0.27,S2016
6,SUNIL BHANDARI,Independent,3236,2,3238,0.23,S2016
7,VISHEK VISHNOI,Independent,1718,32,1750,0.13,S2016
8,SHIVA RAM,Independent,1191,4,1195,0.09,S2016
9,LIKHAMA RAM,Independent,1123,2,1125,0.08,S2016
10,NARESH KANDARA,Independent,1007,20,1027,0.07,S2016
11,SATYANARAYAN,Bharatiya Sampuran Krantikari Party,776,6,782,0.06,S2016
12,PAPPU DAN,Right to Recall Party,650,4,654,0.05,S2016
13,SHAHNAZ BANO,Dalit Kranti Dal,546,1,547,0.04,S2016
14,RAM DAYAL BISHNOI,Rashtriya Janshakti Party (Secular),491,12,503,0.04,S2016
15,BHOM SINGH,Indian Peoples Green Party,483,4,487,0.04,S2016
16,NOTA,None of the Above,10511,80,10591,0.77,S2016
1,MOHMAD HANEEFA,Independent,64443,816,65259,48.15,U091
2,TSERING NAMGYAL,Indian National Congress,35770,1627,37397,27.59,U091
3,TASHI GYALSON,Bharatiya Janata Party,31505,451,31956,23.58,U091
4,NOTA,None of the Above,896,16,912,0.67,U091
1,MURASOLI S,Dravida Munnetra Kazhagam,498822,3423,502245,48.82,S2230
2,SIVANESAN P,Desiya Murpokku Dravida Kazhagam,182172,490,182662,17.76,S2230
3,MURUGANANTHAM M,Bharatiya Janata Party,169587,1026,170613,16.59,S2230
4,HUMAYUN KABIR,Naam Tamilar Katchi,119683,610,120293,11.69,S2230
5,RENGASAMY C,Independent,18130,61,18191,1.77,S2230
6,SARAVANAN M,Independent,6730,65,6795,0.66,S2230
7,SENTHIL KUMAR N,Independent,4133,25,4158,0.4,S2230
8,EZHILARASAN S,Independent,3834,17,3851,0.37,S2230
9,JAYABAL A,Bahujan Samaj Party,2400,10,2410,0.23,S2230
10,SANTHOSH M,Independent,1982,10,1992,0.19,S2230
11,ER ARJUN S,Independent,1440,6,1446,0.14,S2230
12,KARIKALA CHOLAN S,Independent,1209,8,1217,0.12,S2230
13,NOTA,None of the Above,12674,159,12833,1.25,S2230
1,VIJAY KUMAR HANSDAK,Jharkhand Mukti Morcha,607293,6078,613371,50.35,S271
2,TALA MARANDI,Bharatiya Janata Party,430544,4563,435107,35.72,S271
3,LOBIN HEMBRAM,Independent,41592,548,42140,3.46,S271
4,GOPIN SOREN,Communist Party of India  (Marxist),37191,100,37291,3.06,S271
5,MAHESH PAHARIYA,Independent,14950,28,14978,1.23,S271
6,AJIT MARANDI,Rashtriya Jansambhavna Party,11243,8,11251,0.92,S271
7,SEBASTION HEMBROM,Independent,9492,1,9493,0.78,S271
8,MARIYAM MARANDI,Bahujan Samaj Party,8225,34,8259,0.68,S271
9,PAUL SOREN,All India Majlis-E-Ittehadul Muslimeen,7854,48,7902,0.65,S271
10,DIPA TUDU,Independent,6847,9,6856,0.56,S271
11,KHALIFA KISKU,Peoples Party of India (Democratic),4092,15,4107,0.34,S271
12,VINOD KUMAR MANDAL,Lokhit Adhikar Party,3774,35,3809,0.31,S271
13,MUNSHI KISKU,Navyug Pragatisheel Morcha,2777,2,2779,0.23,S271
14,LILI HANSDA,Samata Party,2682,7,2689,0.22,S271
15,NOTA,None of the Above,18119,98,18217,1.5,S271
1,MAHIMA KUMARI MEWAR,Bharatiya Janata Party,775243,5960,781203,64.4,S2022
2,DR. DAMODAR GURJAR,Indian National Congress,385359,3621,388980,32.06,S2022
3,RAMAKISHAN BHADU,Bahujan Samaj Party,9097,38,9135,0.75,S2022
4,NEERU RAM KAPRI,Independent,7820,11,7831,0.65,S2022
5,DHARAM SINGH RAWAT,Independent,3993,60,4053,0.33,S2022
6,NARAYAN SONI,Independent,3367,7,3374,0.28,S2022
7,GHANSHYAM SINGH,Bhartiya Jan Adhikar Party,1917,23,1940,0.16,S2022
8,JITENDRA KUMAR KHATIK,Independent,1802,13,1815,0.15,S2022
9,DR. ARPIT CHHAJER,Independent,1235,9,1244,0.1,S2022
10,PRAMOD KUMAR VERMA,Bheem Tribal Congress,1134,10,1144,0.09,S2022
11,NOTA,None of the Above,12339,72,12411,1.02,S2022
1,MAHUA MOITRA,All India Trinamool Congress,624711,4078,628789,44.1,S2512
2,AMRITA ROY,Bharatiya Janata Party,567628,4456,572084,40.13,S2512
3,S.M. SADI,Communist Party of India  (Marxist),179063,1138,180201,12.64,S2512
4,SANJIT BISWAS,Independent,8660,11,8671,0.61,S2512
5,SOURAV HELA,Independent,5061,4,5065,0.36,S2512
6,NEMAI BISWAS,Independent,5047,22,5069,0.36,S2512
7,AMAL CHANDRA SARKAR,Bahujan Samaj Party,5045,55,5100,0.36,S2512
8,AFROJA KHATUN MONDAL,All India Secular Front,4284,14,4298,0.3,S2512
9,ISMAT ARA MONDAL,Socialist Unity Centre Of India (COMMUNIST),3603,19,3622,0.25,S2512
10,MD. MUKTAR SHAIKH,Independent,3287,7,3294,0.23,S2512
11,ALIK KUMAR KUNDU,Independent,2699,9,2708,0.19,S2512
12,NOTA,None of the Above,6754,57,6811,0.48,S2512
1,RAMESH AWASTHI,Bharatiya Janata Party,440609,2446,443055,49.93,S2443
2,ALOK MISRA,Indian National Congress,419469,2618,422087,47.56,S2443
3,KULDEEP BHADAURIYA,Bahujan Samaj Party,11843,189,12032,1.36,S2443
4,ASHOK PASWAN ADVOCATE,Sabhi Jan Party,1969,5,1974,0.22,S2443
5,ALOK MISHRA,Independent,1186,12,1198,0.14,S2443
6,MANOJ KUMAR,Independent,776,2,778,0.09,S2443
7,AJAY KUMAR MISHRA,Independent,671,1,672,0.08,S2443
8,PRASHAST DHEER,All India Forward Bloc,462,3,465,0.05,S2443
9,ARVIND KUMAR SRIVASTAVA,Independent,394,4,398,0.04,S2443
10,SANJAY SINGH,"Proutist Bloc, India",348,2,350,0.04,S2443
11,VALENDRA KATIYAR,Socialist Unity Centre Of India (COMMUNIST),267,3,270,0.03,S2443
12,NOTA,None of the Above,4048,69,4117,0.46,S2443
1,RAMASAHAYAM RAGHURAM REDDY,Indian National Congress,759603,7326,766929,61.29,S2917
2,NAMA NAGESWARA RAO,Bharat Rashtra Samithi,297592,1490,299082,23.9,S2917
3,VINOD RAO TANDRA,Bharatiya Janata Party,117075,1561,118636,9.48,S2917
4,VASAM RAMAKRISHNA DORA,Independent,6200,15,6215,0.5,S2917
5,ULLENGALA YADAGIRI,Independent,6063,1,6064,0.48,S2917
6,ADVOCATE YERRA KAAMESH,Bahujan Samaj Party,6030,71,6101,0.49,S2917
7,KUKKALA NAGAIAH,Alliance of Democratic Reforms Party,5724,19,5743,0.46,S2917
8,KATUKOJWALA NAGESWAR RAO,Independent,4111,3,4114,0.33,S2917
9,CHILAKABATHINI STALIN,Independent,3112,1,3113,0.25,S2917
10,SHAIK BAJI BABA,Independent,2422,2,2424,0.19,S2917
11,KASIMALLA NAGESWARA RAO,Independent,2232,5,2237,0.18,S2917
12,BANDARU NAGARAJU,Independent,2122,0,2122,0.17,S2917
13,SHAIK KHALEEL PASHA,Independent,2023,5,2028,0.16,S2917
14,EDURUGATLA CHITTI MALLU,Independent,1848,6,1854,0.15,S2917
15,GANGIREDDY KOTI REDDY,Independent,1789,1,1790,0.14,S2917
16,SHAIK SIRAJUDDIN,Independent,1661,2,1663,0.13,S2917
17,SHAIK AJJULU,Independent,1342,0,1342,0.11,S2917
18,KOPPULA SRINIVASA RAO,Jaibhim Rao Bharat Party,1271,2,1273,0.1,S2917
19,MADDISETTY YERRAPPA @ AJAY,Independent,1043,10,1053,0.08,S2917
20,SHAIK MOHMED RASOOL,Independent,1021,1,1022,0.08,S2917
21,LINGALA RAVI KUMAR,Independent,1017,1,1018,0.08,S2917
22,AVUTAPALLI RAMBABU,Independent,948,2,950,0.08,S2917
23,TEJAVATH JOGRAM NAIK,Independent,914,5,919,0.07,S2917
24,ANWAR RAICE,Socialist Party (India),754,0,754,0.06,S2917
25,ANANDA PRASAD KASINA,Pyramid Party of India,714,4,718,0.06,S2917
26,LINGAIAH DANDA,Independent,693,7,700,0.06,S2917
27,ANIL KUMAR MADDINENI,Independent,689,4,693,0.06,S2917
28,PAPETLA RAMAMURTHY,Sakala Janula Party,659,2,661,0.05,S2917
29,ANTHONI SURESH,Bahujana Left Party,607,9,616,0.05,S2917
30,M. RAVI CHANDAR CHOWHAN,Independent,597,4,601,0.05,S2917
31,THAMBALLA RAVI,Independent,503,5,508,0.04,S2917
32,BHATTU SRINIVAS,Jai Bharat National Party,472,4,476,0.04,S2917
33,NAGESWARA RAO LAKAVATH,Independent,363,5,368,0.03,S2917
34,MALAMPATI SURYANARAYANA,Independent,362,1,363,0.03,S2917
35,MUTYAM ARJUNA RAJU,Independent,349,2,351,0.03,S2917
36,NOTA,None of the Above,6657,125,6782,0.54,S2917
1,ROBERT BRUCE C,Indian National Congress,499493,2803,502296,47.06,S2238
2,NAINAR NAGENTHRAN,Bharatiya Janata Party,334431,2245,336676,31.54,S2238
3,JANSI RANI M,All India Anna Dravida Munnetra Kazhagam,88996,605,89601,8.39,S2238
4,SATHYA,Naam Tamilar Katchi,86918,768,87686,8.21,S2238
5,POTTAL SUNDARA MUNISWARAN,Independent,19802,50,19852,1.86,S2238
6,ATHISAYAM V,Independent,3744,37,3781,0.35,S2238
7,BALASUBRAMANIAN,Bahujan Samaj Party,2044,23,2067,0.19,S2238
8,CHINNA MAHARAJA K,Independent,1888,7,1895,0.18,S2238
9,DAVID M,Independent,1829,7,1836,0.17,S2238
10,SAMUEL LAWRENCE PONNIAH,Independent,1493,4,1497,0.14,S2238
11,BISHOP DR GODFREY WASHINGTON NOBLE,Aanaithinthiya Jananayaka Pathukappu Kazhagam,1457,18,1475,0.14,S2238
12,LENIN K,Independent,1441,9,1450,0.14,S2238
13,CHANDRAN M,Veerath Thiyagi Viswanathadoss Thozhilalarkal Katchi,1409,4,1413,0.13,S2238
14,SELVA KUMAR S,Bahujan Dravida Party,1317,29,1346,0.13,S2238
15,KUMAR V,Puthiya Makkal Tamil Desam Katchi,1057,15,1072,0.1,S2238
16,MUTHURAMAN A,Aravor Munnetra Kazhagam,1046,2,1048,0.1,S2238
17,THALAPATHY MURUGAN M,Independent,913,4,917,0.09,S2238
18,SIVARAM K,Independent,855,20,875,0.08,S2238
19,RAMAKRISHNAN N,Nam India Naam Indiyar Katchi,790,0,790,0.07,S2238
20,SURESH,Independent,777,11,788,0.07,S2238
21,DR RAJENDRA RETNAM K,Independent,685,4,689,0.06,S2238
22,SEVAL KANNAN B ADVOCATE,Independent,622,14,636,0.06,S2238
23,RAGHAVAN C M,Independent,364,2,366,0.03,S2238
24,NOTA,None of the Above,7285,111,7396,0.69,S2238
1,DHAIRYASHEEL SAMBHAJIRAO MANE,Shiv Sena,518334,1856,520190,40.14,S1348
2,SATYAJEET BABASAHEB PATIL (AABA) SARUDKAR,Shiv Sena (Uddhav Balasaheb Thackrey),504181,2583,506764,39.1,S1348
3,RAJU SHETTI,Swabhimani Paksha,178866,984,179850,13.88,S1348
4,D. C. PATIL DADASAHEB / DADGONDA CHAVGONDA PATIL,Vanchit Bahujan  Aaghadi,32591,105,32696,2.52,S1348
5,ASLAM AINODIN MULLA,Independent,6107,4,6111,0.47,S1348
6,ANANDRAO VASANTRAO SARNAIK (FOUJI BAPU),Independent,4944,11,4955,0.38,S1348
7,TANDALE LAXMAN SHIVAJI,Independent,4788,1,4789,0.37,S1348
8,PROF. PARASHURAM MANE,Independent,4467,10,4477,0.35,S1348
9,KAMBLE RAVINDRA TUKARAM,Bahujan Samaj Party,3968,65,4033,0.31,S1348
10,SATYAJEET PATIL (AABA),Independent,3602,30,3632,0.28,S1348
11,ANANDRAO TUKARAM THORAT,Independent,3497,2,3499,0.27,S1348
12,IMRAN IQBAL KHATIB,Bahujan Mukti Party,3172,18,3190,0.25,S1348
13,RAGHUNATHDADA PATIL,Bharatheeya Jawan Kisan Party,2146,28,2174,0.17,S1348
14,JAVED SIKANDAR MUJAVAR,Independent,1849,3,1852,0.14,S1348
15,SANTOSH KERBA KHOT,Kamgaar Kisan Party,1697,4,1701,0.13,S1348
16,DR. ISHWAR MAHADEV YAMGAR,Bharatiya Lokshakti Party,1520,17,1537,0.12,S1348
17,SHIVAJI DHONDIRAM SANKPAL,Independent,1390,2,1392,0.11,S1348
18,SHARAD BABURAO PATIL,National Black Panther Party,1356,5,1361,0.11,S1348
19,MANOHAR PRADIP SATPUTE,Independent,1063,3,1066,0.08,S1348
20,DHANAJI JAGANNATH GURAV (SHIVAREKAR),Lokrajya Janata Party,1054,7,1061,0.08,S1348
21,DAVARI LAXMAN SHRIPATI,Independent,1004,5,1009,0.08,S1348
22,RAJENDRA BHIMRAO MANE,Independent,935,5,940,0.07,S1348
23,DINAKARRAO TULSHIDAS CHAVAN (PATIL),All India Forward Bloc,674,5,679,0.05,S1348
24,RAMCHANDRA GOVINDRAO SALUNKHE,Independent,618,0,618,0.05,S1348
25,MOHITE DEVENDRA NANA,Independent,559,1,560,0.04,S1348
26,MANE ARVIND BHIVA,Independent,422,2,424,0.03,S1348
27,MAHAMMAD MUBARAK DARAVESHI,Independent,360,1,361,0.03,S1348
28,NOTA,None of the Above,5027,76,5103,0.39,S1348
1,ISHA KHAN CHOUDHURY,Indian National Congress,570966,1429,572395,41.79,S258
2,SREERUPA MITRA CHAUDHURY (NIRBHAYA DIDI),Bharatiya Janata Party,441531,2496,444027,32.42,S258
3,SHAHNAWAZ ALI RAIHAN,All India Trinamool Congress,299825,1201,301026,21.98,S258
4,PURNOCHANDRA MANDAL,Independent,8381,2,8383,0.61,S258
5,AHMED HEDATUL HASAN,Independent,5735,1,5736,0.42,S258
6,MD. JAMAL SAIKH,Independent,5386,0,5386,0.39,S258
7,BIKASH RABIDAS,Bahujan Samaj Party,5054,11,5065,0.37,S258
8,BIJOY KUMAR SARKAR,Independent,4773,3,4776,0.35,S258
9,SUSMITA DEY KARJEE,Bhartiya Lokmat Rashtrwadi Party,3521,14,3535,0.26,S258
10,AMAL KUMAR RABIDAS,Independent,3263,8,3271,0.24,S258
11,KAVIR MADAN DAS,Ambedkarite Party of India,3137,3,3140,0.23,S258
12,ASIM MANDAL,Jan Sangh Party,2786,2,2788,0.2,S258
13,MD SHAHNAWAJ RAHMATULLAH,Social Democratic Party Of India,2315,8,2323,0.17,S258
14,JALALUDDIN SARKAR,Bharatiya Nyay-Adhikar Raksha Party,2075,0,2075,0.15,S258
15,ANGSHUDHAR MANDAL,Socialist Unity Centre Of India (COMMUNIST),1178,11,1189,0.09,S258
16,MD NUR ISLAM SEKH,Rashtriya Secular Majlis Party,1130,6,1136,0.08,S258
17,MD MONIRUL HASAN,Jamat-E-Seratul Mustakim,737,4,741,0.05,S258
18,NOTA,None of the Above,2759,38,2797,0.2,S258
1,R.K. CHAUDHARY,Samajwadi Party,666560,1309,667869,48.49,S2434
2,KAUSHAL KISHORE,Bharatiya Janata Party,596197,1380,597577,43.38,S2434
3,RAJESH KUMAR,Bahujan Samaj Party,88257,204,88461,6.42,S2434
4,MAHENDRA,Independent,2654,7,2661,0.19,S2434
5,SUSHIL KUMAR,Independent,2626,1,2627,0.19,S2434
6,RAMESH KUMAR,Independent,1839,2,1841,0.13,S2434
7,SUNITA CHHEDA PASI,Aam Janta Party (India),1736,13,1749,0.13,S2434
8,S. L.SINGH,Peoples Party of India (Democratic),1711,6,1717,0.12,S2434
9,BRIJESH KUMAR VIKRAM,Rashtriya Samaj Paksha,1648,7,1655,0.12,S2434
10,JITENDRA KUMAR,Independent,1402,12,1414,0.1,S2434
11,SURAJ KUMAR,Sardar Patel Siddhant Party,1010,5,1015,0.07,S2434
12,NOTA,None of the Above,8838,28,8866,0.64,S2434
1,B K PARTHASARATHI,Telugu Desam,713013,12521,725534,51.23,S0120
2,J SHANTHA,Yuvajana Sramika Rythu Congress Party,587406,5701,593107,41.88,S0120
3,B A SAMAD SHAHEEN,Indian National Congress,53989,1070,55059,3.89,S0120
4,BHAGYA R S,Bahujan Samaj Party,7949,66,8015,0.57,S0120
5,PRATHAP REDDY GORLA,Independent,5380,64,5444,0.38,S0120
6,H D HANUMANTHE GOWD,Independent,2270,8,2278,0.16,S0120
7,ANJINAPPA GARI SREENIVASULU,Revolutionary Socialist Party,2045,6,2051,0.14,S0120
8,S N SURESH,Independent,1611,20,1631,0.12,S0120
9,DASAGANIPALLI KULLAYAPPA,Independent,1317,11,1328,0.09,S0120
10,ASHOK,Socialist Unity Centre Of India (COMMUNIST),1282,10,1292,0.09,S0120
11,T SUDHAKAR REDDY,Independent,1227,10,1237,0.09,S0120
12,S RAGHUNATHA REDDY,Independent,693,17,710,0.05,S0120
13,BUDILI DHANUNJAYA,National Nava Kranthi Party,679,3,682,0.05,S0120
14,NOTA,None of the Above,17826,145,17971,1.27,S0120
1,DAROGA PRASAD SAROJ,Samajwadi Party,437567,2392,439959,43.85,S2468
2,NEELAM SONKER,Bharatiya Janata Party,324106,830,324936,32.38,S2468
3,INDU CHAUDHRI,Bahujan Samaj Party,209308,745,210053,20.93,S2468
4,GANGADEEN,Communist Party of India,12263,8,12271,1.22,S2468
5,BALINDAR,Janta Kranti Party (Rashtravadi),4157,1,4158,0.41,S2468
6,SUSHMITA SAROJ,Independent,2621,5,2626,0.26,S2468
7,RAM PYARE SHARAN VIJAITA,Independent,2337,4,2341,0.23,S2468
8,NOTA,None of the Above,7075,19,7094,0.71,S2468
1,SAPTAGIRI SANKAR ULAKA,Indian National Congress,469295,2098,471393,41.03,S1821
2,KAUSALYA HIKAKA,Biju Janata Dal,322797,852,323649,28.17,S1821
3,KALIRAM MAJHI,Bharatiya Janata Party,230792,1722,232514,20.24,S1821
4,DAMINI JANI,Bahujan Samaj Party,15373,54,15427,1.34,S1821
5,PRAKASH HIKAKA,Communist Party of India  (Marxist-Leninist)  (Liberation),14847,5,14852,1.29,S1821
6,LASU HANTAL,Independent,14362,11,14373,1.25,S1821
7,RAGHUMANI GOMANGO,Independent,10528,12,10540,0.92,S1821
8,ABINASH GOMANGO,Independent,10258,16,10274,0.89,S1821
9,SUMAN KANTA,Naba Bharata Nirmana Seva Party,8386,10,8396,0.73,S1821
10,SANTOSH KUMAR BIDIKA,Republican Party of India (A),5413,2,5415,0.47,S1821
11,PRAMILA PUJARI,Socialist Unity Centre Of India (COMMUNIST),4866,12,4878,0.42,S1821
12,NOTA,None of the Above,37106,25,37131,3.23,S1821
1,JOYANTA BASUMATARY,"United People’s Party, Liberal",484681,4314,488995,39.39,S031
2,KAMPA BORGOYARI,Bodoland Peoples Front,432768,4644,437412,35.23,S031
3,GARJAN MASHAHARY,Indian National Congress,112624,1112,113736,9.16,S031
4,BINITA DEKA,Gana Suraksha Party,93266,923,94189,7.59,S031
5,PRITHVIRAJ NARAYAN DEV MECH,Independent,33636,101,33737,2.72,S031
6,GAURI SANKAR SARANIA,All India Trinamool Congress,23362,157,23519,1.89,S031
7,RANJAY KR BRAHMA,Independent,8782,48,8830,0.71,S031
8,LALIT PEGU,Voters Party  International,7891,41,7932,0.64,S031
9,JYOTISH KUMAR DAS,Independent,5944,162,6106,0.49,S031
10,PANKAJ ISLARY,Independent,4473,35,4508,0.36,S031
11,TRIPTINA RABHA,Independent,4425,115,4540,0.37,S031
12,AJOY NARZARY,Independent,4032,48,4080,0.33,S031
13,NOTA,None of the Above,13662,250,13912,1.12,S031
1,BANDI SANJAY KUMAR,Bharatiya Janata Party,578827,6289,585116,44.57,S293
2,VELCHALA RAJENDER RAO,Indian National Congress,357446,2461,359907,27.41,S293
3,VINOD KUMAR BOIANAPALLI,Bharat Rashtra Samithi,280867,1296,282163,21.49,S293
4,ABBADI BUCHI REDDY,Independent,11602,10,11612,0.88,S293
5,ARUNA THALLAPALLY,Alliance of Democratic Reforms Party,9043,21,9064,0.69,S293
6,KOTA SHYAM KUMAR,Independent,8744,12,8756,0.67,S293
7,ANOSE KATKOORI,Independent,8699,7,8706,0.66,S293
8,MAREPALLI MOGILAIAH,Bahujan Samaj Party,8010,99,8109,0.62,S293
9,RAJENDER POTHURI,Independent,3250,7,3257,0.25,S293
10,SRAVAN PEDDAPELLY,Bharathiya YuvaKula Dalam,3068,6,3074,0.23,S293
11,GADDA SATHISH,Independent,2936,9,2945,0.22,S293
12,ANILREDDY KADTHALA,National Nava Kranthi Party,2747,7,2754,0.21,S293
13,CHILUVERU SRIKANTH,Dharma Samaj Party,2553,33,2586,0.2,S293
14,AKSHAY KUMAR MEKALA,Independent,2219,5,2224,0.17,S293
15,JOURNALIST VIKRAM REDDY VEMULAA,Independent,2090,6,2096,0.16,S293
16,ASHOK PANCHIKA,Social Justice Party of India,1914,10,1924,0.15,S293
17,GAVVALA LAXMI,Independent,1738,6,1744,0.13,S293
18,GATTAIAH YADAV BARIGE,Independent,1688,6,1694,0.13,S293
19,RANAPRATAP GATTU,Socialist Party (India),1606,7,1613,0.12,S293
20,GUDISHE  MOHAN,Independent,1471,3,1474,0.11,S293
21,MANASA PERALA,Independent,1106,19,1125,0.09,S293
22,PODISHETTI SAMMAIAH,Bahujan Mukti Party,994,0,994,0.08,S293
23,VENKATANARSAIAH DYAGALA @ DEGALA,Independent,926,2,928,0.07,S293
24,SHIVARATRI SRINIVAS,Independent,887,2,889,0.07,S293
25,CHINTHA ANILKUMAR,Pyramid Party of India,823,7,830,0.06,S293
26,CHEEKOTI VARUN KUMAR GUPTA,Telugu Congress Party,783,7,790,0.06,S293
27,RAPOLE RAMKUMAR BHARADWAJ,Independent,572,3,575,0.04,S293
28,DEVUNOORI SRINIVASU,Independent,465,0,465,0.04,S293
29,NOTA,None of the Above,5373,65,5438,0.41,S293
1,NITYANAND RAI,Bharatiya Janata Party,515159,806,515965,49.51,S0422
2,ALOK KUMAR MEHTA,Rashtriya Janata Dal,454870,993,455863,43.75,S0422
3,SANJAY PASWAN,Independent,16961,2,16963,1.63,S0422
4,MOHAN KUMAR MAURYA,Bahujan Samaj Party,7081,20,7101,0.68,S0422
5,RAKESH KUMAR,Independent,5953,4,5957,0.57,S0422
6,SANTHOSH RAI,Rashtriya Jansambhavna Party,4423,3,4426,0.42,S0422
7,NARENDRA GIRI,Independent,3150,1,3151,0.3,S0422
8,KISHOR KUMAR,Independent,2209,0,2209,0.21,S0422
9,AMARESH RAY,Independent,2140,3,2143,0.21,S0422
10,ANSHU KUMAR,Subhashwadi Bhartiya Samajwadi Party (Subhas Party),1749,7,1756,0.17,S0422
11,RAMPUKAR RAY,Socialist Unity Centre Of India (COMMUNIST),1299,7,1306,0.13,S0422
12,NIKKI JHA,Jagrook Janta Party,1006,14,1020,0.1,S0422
13,MANOJ KUMAR,Janta Raj Vikas Party,937,2,939,0.09,S0422
14,NOTA,None of the Above,23246,23,23269,2.23,S0422
1,H.D. KUMARASWAMY,Janata Dal  (Secular),847482,4399,851881,58.34,S1020
2,VENKATARAMANE GOWDA (STAR CHANDRU),Indian National Congress,564778,2483,567261,38.85,S1020
3,CHANDAN GOWDA. K,Independent,12310,84,12394,0.85,S1020
4,SHIVASHANKARA. S,Bahujan Samaj Party,6903,61,6964,0.48,S1020
5,RAMAIAH. D,Independent,3796,14,3810,0.26,S1020
6,RANJITHA. N,Independent,2897,12,2909,0.2,S1020
7,CHANDRASHEKARA. K.R (CHANDRU KEELARA),Karnataka Rashtra Samithi,1465,11,1476,0.1,S1020
8,BUDAYYA. B.P,Karunaadu Party,1358,12,1370,0.09,S1020
9,LOKESHA. S (AARYA LOKESH),Uttama Prajaakeeya Party,1151,12,1163,0.08,S1020
10,BEERESH. C.T (SAINIKA BEERESH),Independent,919,12,931,0.06,S1020
11,N.BASAVARAJU,Independent,802,41,843,0.06,S1020
12,H.D. REVANNA,Purvanchal Mahapanchayat,584,6,590,0.04,S1020
13,CHANNAMAYIGOWDA,Independent,496,1,497,0.03,S1020
14,S.ARVIND,Independent,440,2,442,0.03,S1020
15,NOTA,None of the Above,7706,30,7736,0.53,S1020
1,BENNY BEHANAN,Indian National Congress,390216,3955,394171,41.44,S1111
2,PROF C RAVEENDRANATH,Communist Party of India  (Marxist),327382,3035,330417,34.73,S1111
3,K A UNNIKRISHNAN,Bharath Dharma Jana Sena,105706,694,106400,11.18,S1111
4,ADV CHARLY PAUL,Twenty 20 Party,105020,622,105642,11.11,S1111
5,ROSILIN CHACKO,Bahujan Samaj Party,2377,33,2410,0.25,S1111
6,BOSCO KALAMASSERY,Independent,1071,16,1087,0.11,S1111
7,SUBRAN K R,Independent,789,10,799,0.08,S1111
8,DR M PRADEEPAN,Socialist Unity Centre Of India (COMMUNIST),688,6,694,0.07,S1111
9,ARUN EDATHADAN,Independent,662,24,686,0.07,S1111
10,T S CHANDRAN,Independent,481,50,531,0.06,S1111
11,JOHNSON K C,Independent,379,8,387,0.04,S1111
12,NOTA,None of the Above,8021,42,8063,0.85,S1111
1,KOTA SRINIVAS POOJARY,Bharatiya Janata Party,728219,4015,732234,59.56,S1015
2,K. JAYAPRAKASH HEGDE,Indian National Congress,470769,2290,473059,38.48,S1015
3,K.T. RADHAKRISHNA,Bahujan Samaj Party,5378,39,5417,0.44,S1015
4,SUDHEER KANCHAN MARAKALA,Independent,2281,5,2286,0.19,S1015
5,SACHIN B.K,Uttama Prajaakeeya Party,1299,34,1333,0.11,S1015
6,M. K. DAYANANDA,Proutist Sarva Samaj,1049,20,1069,0.09,S1015
7,VIJAY KUMAR M. G,Independent,943,13,956,0.08,S1015
8,SUPREETH KUMAR POOJARY KATEEL,Janahitha Paksha,670,20,690,0.06,S1015
9,SHABAREESH,Karunada Sevakara Party,560,5,565,0.05,S1015
10,L. RANGANATH GOWDA,Karnataka Rashtra Samithi,536,4,540,0.04,S1015
11,NOTA,None of the Above,11235,34,11269,0.92,S1015
1,CHARANJIT SINGH CHANNI,Indian National Congress,389509,544,390053,39.43,S194
2,SUSHIL KUMAR RINKU,Bharatiya Janata Party,213702,358,214060,21.64,S194
3,PAWAN KUMAR TINU,Aam Aadmi Party,208549,340,208889,21.12,S194
4,MOHINDER SINGH KAYPEE,Shiromani Akali Dal,67811,100,67911,6.87,S194
5,ADVOCATE BALWINDER KUMAR,Bahujan Samaj Party,64856,85,64941,6.57,S194
6,SARABJIT SINGH KHALSA,Shiromani Akali Dal (Amritsar)(Simranjit Singh Mann),19252,32,19284,1.95,S194
7,MASTER PARSHOTAM LAL BILGA,Communist Party of India  (Marxist),5948,10,5958,0.6,S194
8,IQBAL CHAND MATTU,Independent,1956,0,1956,0.2,S194
9,NEETU SHATTRA WALA,Independent,1878,1,1879,0.19,S194
10,AMRISH BHAGAT,Independent,1183,1,1184,0.12,S194
11,GURDEEP SINGH BITTU,Independent,1112,1,1113,0.11,S194
12,RAJ KUMAR SAQI,Peoples Party of India (Democratic),1087,1,1088,0.11,S194
13,SONIA,Republican Party of India (Athawale),1054,1,1055,0.11,S194
14,RAJWANT KAUR KHALSA,Apna Samaj Party,948,4,952,0.1,S194
15,BHAGAT GULSHAN AZAAD,Democratic Bharatiya Samaj Party,929,1,930,0.09,S194
16,RAMESH LAL KALA,Independent,875,1,876,0.09,S194
17,ASHOK KUMAR JAKHU,Independent,742,1,743,0.08,S194
18,BAL MUKAND BAWRA,Global Republican Party,587,4,591,0.06,S194
19,PARAMJIT KAUR TEJI,Independent,500,0,500,0.05,S194
20,TARACHAND SHEELA,Loktantrik Lok Rajyam Party,400,1,401,0.04,S194
21,NOTA,None of the Above,4724,19,4743,0.48,S194
1,DEVENDRA SINGH ALIAS BHOLE SINGH,Bharatiya Janata Party,514256,3167,517423,47.6,S2444
2,RAJARAM PAL,Samajwadi Party,469766,3312,473078,43.52,S2444
3,RAJESH KUMAR DWIVEDI,Bahujan Samaj Party,72679,461,73140,6.73,S2444
4,RAJARAM,Independent,4629,13,4642,0.43,S2444
5,ASHOK PASWAN ADVOCATE,Sabhi Jan Party,3160,13,3173,0.29,S2444
6,CHANDRESH SINGH,Bhartiya Shakti Chetna Party,2641,13,2654,0.24,S2444
7,YOGESH JAISWAL,Independent,2529,14,2543,0.23,S2444
8,VIPIN KUMAR,Rashtriya Sanskriti Party,1489,5,1494,0.14,S2444
9,RAMGOPAL,Rashtriya Janutthan Party,1146,11,1157,0.11,S2444
10,NOTA,None of the Above,7523,126,7649,0.7,S2444
1,RAMASHANKAR RAJBHAR,Samajwadi Party,403616,1856,405472,44.2,S2471
2,RAVINDAR KUSHAWAHA,Bharatiya Janata Party,400489,1410,401899,43.81,S2471
3,BHIM RAJBHAR,Bahujan Samaj Party,80291,308,80599,8.79,S2471
4,JAIBAHADUR ALIAS JAIBAHADUR CHAUHAN,Janta Kranti Party (Rashtravadi),8241,22,8263,0.9,S2471
5,SHREENARAYAN MISHRA,Akhil Bhartiya Sarvjan Hit Party,3878,14,3892,0.42,S2471
6,SADDAM HUSSAIN,Independent,3210,5,3215,0.35,S2471
7,SHRIKRISHNA,Independent,2527,5,2532,0.28,S2471
8,AMRESH THAKUR,Independent,2147,9,2156,0.24,S2471
9,SURYA PRAKASH GAUTAM,Sardar Patel Siddhant Party,1782,3,1785,0.19,S2471
10,NOTA,None of the Above,7520,29,7549,0.82,S2471
1,PRATIMA MONDAL,All India Trinamool Congress,891053,3259,894312,60.32,S2519
2,ASHOK KANDARY,Bharatiya Janata Party,422546,1547,424093,28.6,S2519
3,MEGHNATH HALDER,All India Secular Front,65316,56,65372,4.41,S2519
4,SAMARENDRA NATH MONDAL,Revolutionary Socialist Party,39927,186,40113,2.71,S2519
5,NIRANJAN  NASKAR,Socialist Unity Centre Of India (COMMUNIST),14547,75,14622,0.99,S2519
6,SUJAN SARDAR,Independent,10779,15,10794,0.73,S2519
7,SINDHUPADA BAIRAGI,Independent,9150,12,9162,0.62,S2519
8,SHANKAR DEB MONDAL,Bahujan Samaj Party,6363,28,6391,0.43,S2519
9,JURAN CHANDRA PANDEY,Mulnibasi Party of India,3750,19,3769,0.25,S2519
10,MILAN NASKAR,Independent,2129,7,2136,0.14,S2519
11,PRATIMA MONDAL,Independent,2052,27,2079,0.14,S2519
12,NOTA,None of the Above,9756,32,9788,0.66,S2519
1,GANESH SINGH,Bharatiya Janata Party,458373,1355,459728,43.41,S129
2,DABBU SIDDHARTH SUKHLAL KUSHWAHA,Indian National Congress,373982,797,374779,35.39,S129
3,NARAYAN TRIPATHI,Bahujan Samaj Party,185303,315,185618,17.53,S129
4,DURGESH KUMAR VISHWAKARMA,Independent,5919,2,5921,0.56,S129
5,RAHUL DAHIYA,Independent,4276,1,4277,0.4,S129
6,CHHEDI LAL PRAJAPATI (PANDA  BABA),Independent,4060,1,4061,0.38,S129
7,CHANDRABHAN KOL,Independent,3393,5,3398,0.32,S129
8,"SAFI ULLA ""DBBU BHAI""",Independent,2612,2,2614,0.25,S129
9,ADV. ASHOK SAKET,Bahujan Dravida Party,2396,3,2399,0.23,S129
10,AZEEZ AHMED QURAISHY,Manviya Bharat Party,2078,4,2082,0.2,S129
11,MASTER JI AJIT KUMAR JAYSWAL,Peoples Party of India (Democratic),1887,4,1891,0.18,S129
12,KALIM AHMAD BACHCHA,Independent,1622,8,1630,0.15,S129
13,SUKHLAL VERMA RATNESH,Independent,1616,1,1617,0.15,S129
14,ASHOK KUMAR GUPTA,Bhartiya Shakti Chetna Party,1259,6,1265,0.12,S129
15,NANKU YADAV,Akhil Bharatiya Hind Kranti Party,1254,5,1259,0.12,S129
16,RISHABH SINGH,Independent,1068,5,1073,0.1,S129
17,ASHOK BAUDH,Independent,945,2,947,0.09,S129
18,HARI SHANKAR TIWARI (LOHA WALA),Bharatiya Jan Morcha Party,935,10,945,0.09,S129
19,RANJANA MISHRA,Nyaydharmsabha,905,10,915,0.09,S129
20,NOTA,None of the Above,2538,15,2553,0.24,S129
1,MAGUNTA SREENIVASULU REDDY,Telugu Desam,689829,12065,701894,49.35,S0116
2,DR CHEVIREDDY BHASKAR REDD,Yuvajana Sramika Rythu Congress Party,644052,7643,651695,45.82,S0116
3,EDA SUDHAKARA REDDY,Indian National Congress,25803,919,26722,1.88,S0116
4,DHARANIKOTA LAKSHMI NARAYANA,Bahujan Samaj Party,6238,76,6314,0.44,S0116
5,BUCHI EDUKONDALU,Independent,3046,2,3048,0.21,S0116
6,PODILI RAMBABU,Independent,3035,38,3073,0.22,S0116
7,ORSU VEENA,Jai Bharat National Party,2242,25,2267,0.16,S0116
8,BONTHA RANGA REDDY,Independent,1923,0,1923,0.14,S0116
9,BODDU KRANTHI KUMAR,Independent,1797,1,1798,0.13,S0116
10,MOHAN GOUD J V,Independent,1442,5,1447,0.1,S0116
11,U MADHU BABU,Independent,1006,2,1008,0.07,S0116
12,KARATAPU RAJU,Independent,730,5,735,0.05,S0116
13,JAGADEESH RAYAPATI,Independent,713,12,725,0.05,S0116
14,DEVIREDDY BALANJANEYULU,Independent,710,6,716,0.05,S0116
15,HARI PRASAD TUPAKULA,Independent,706,5,711,0.05,S0116
16,PASAM VENKATESWARLU YADAV,Samajwadi Party,699,44,743,0.05,S0116
17,SURYA TEJA KOTA,Pyramid Party of India,674,9,683,0.05,S0116
18,AKUMALLA MALLIKARJUNA REDDY,Independent,575,0,575,0.04,S0116
19,VESHAPOGU GURAVABABU,Independent,457,4,461,0.03,S0116
20,KOMMU YOHANU,Liberation Congress Party,454,7,461,0.03,S0116
21,SESHUBABU GUDDANTI,Independent,449,0,449,0.03,S0116
22,SINGAMNENI SREEKANTH,Independent,407,3,410,0.03,S0116
23,YARRA DASARADHARAMAIAH,Independent,394,0,394,0.03,S0116
24,KOTA VAMSI KRISHNA,Independent,365,0,365,0.03,S0116
25,K PAVAN KALYAN,Jatiya Jana Sena Party,362,30,392,0.03,S0116
26,NOTA,None of the Above,13066,139,13205,0.93,S0116
1,POONAMBEN HEMATBHAI MAADAM,Bharatiya Janata Party,618120,1929,620049,58.98,S0612
2,ADVOCATE J. P. MARAVIYA,Indian National Congress,380949,1092,382041,36.34,S0612
3,JAYSUKH NATHUBHAI PINGALSUR,Bahujan Samaj Party,11429,33,11462,1.09,S0612
4,KANZARIYA RANCHHODBHAI NARANBHAI,Viro Ke Vir Indian Party,6973,29,7002,0.67,S0612
5,VIJAYSINH PRAVINSINH JADEJA,Independent,4817,17,4834,0.46,S0612
6,RATHOD PUNJABHAI PALABHAI,Independent,3727,5,3732,0.36,S0612
7,BHURALAL MEGHJIBHAI PARMAR,Independent,1923,5,1928,0.18,S0612
8,GHUGHA ALARAKHABHAI ISHAKBHAI,Independent,1582,3,1585,0.15,S0612
9,KHIRA YUSUF SIDIKBHAI,Independent,1368,3,1371,0.13,S0612
10,NANJI AMARSHI BATHWAR,Independent,1365,5,1370,0.13,S0612
11,ANWAR NOORMAMAD SANGHAR,Independent,1299,0,1299,0.12,S0612
12,PARESHBHAI PARSOTTAMBHAI MUNGARA,Rashtriya Mahaswaraj Bhumi Party,1266,4,1270,0.12,S0612
13,POPATPUTRA RAFIK ABUBAKAR,Independent,1133,5,1138,0.11,S0612
14,NADEEM MAHAMMAD HALA,Independent,1069,1,1070,0.1,S0612
15,NOTA,None of the Above,10972,112,11084,1.05,S0612
1,SUNIL BOSE,Indian National Congress,749926,1745,751671,54.87,S1022
2,BALARAJ.S,Bharatiya Janata Party,561056,1909,562965,41.1,S1022
3,M.KRISHNA MURTHY,Bahujan Samaj Party,15819,84,15903,1.16,S1022
4,C.M.KRISHNA,Dr. Ambedkar People's Party,8074,15,8089,0.59,S1022
5,G.D.RAJAGOPAL (H.D.KOTE),Independent,3949,5,3954,0.29,S1022
6,SUMA.S,Socialist Unity Centre Of India (COMMUNIST),3821,5,3826,0.28,S1022
7,MAHADEVASWAMY B M (PAMPI),Independent,3414,7,3421,0.25,S1022
8,H.K.SWAMY HARADANAHALLI,Independent,3206,2,3208,0.23,S1022
9,PATAS PRADEEP KUMAR.M,Independent,1969,17,1986,0.14,S1022
10,KADAMBA. NAA. AMBARISH,Independent,1738,5,1743,0.13,S1022
11,NINGARAJU.S,Karnataka Jantha Paksha,1406,5,1411,0.1,S1022
12,KANDALLI MAHESH,Karnataka Rashtra Samithi,1249,3,1252,0.09,S1022
13,NINGARAJ.G,Independent,1236,11,1247,0.09,S1022
14,PRASANNA KUMAR.B,Karnataka Praja Party (RaithaParva),972,6,978,0.07,S1022
15,NOTA,None of the Above,8094,49,8143,0.59,S1022
1,DURAI VAIKO,Marumalarchi Dravida Munnetra Kazhagam,538877,3336,542213,51.35,S2224
2,KARUPPAIAH. P,All India Anna Dravida Munnetra Kazhagam,227445,1674,229119,21.7,S2224
3,RAJESSH. T,Naam Tamilar Katchi,106752,706,107458,10.18,S2224
4,SENTHILNATHAN. P,Amma Makkal Munnettra Kazagam,99561,1186,100747,9.54,S2224
5,SELVARAJ. S,Independent,14781,15,14796,1.4,S2224
6,DAMODARAN. S,Independent,5138,28,5166,0.49,S2224
7,ALLIMUTHU. M,Bahujan Samaj Party,4353,78,4431,0.42,S2224
8,RAJENDRAN. S,Independent,3489,10,3499,0.33,S2224
9,JEEVANANTHAM. M,Independent,2879,73,2952,0.28,S2224
10,SAKTHIVEL,Anna Puratchi Thalaivar Amma Dravida Munnetra Kazhagam,2587,59,2646,0.25,S2224
11,KARUPPIAH. S,Independent,2156,15,2171,0.21,S2224
12,BACKIYARAJ VELLAISAMY,Naadaalum Makkal Katchi,2120,163,2283,0.22,S2224
13,SATHIS KUMAR. S,Independent,2048,4,2052,0.19,S2224
14,KAVITHA. S,Independent,1719,17,1736,0.16,S2224
15,NAGARAJAN. M,Independent,1656,8,1664,0.16,S2224
16,GOVINDARASU. P,Independent,1562,4,1566,0.15,S2224
17,ANBIN AMUDHAN. R,Independent,1492,6,1498,0.14,S2224
18,DURAIRAJ. A,Independent,1455,8,1463,0.14,S2224
19,SASIKUMAR. P,Independent,1346,6,1352,0.13,S2224
20,PANNEERSELVAM. P,Independent,1255,8,1263,0.12,S2224
21,DURAI. S,Independent,1198,4,1202,0.11,S2224
22,ANAND SELVARAJ,Independent,1172,6,1178,0.11,S2224
23,SANKAR. R,Independent,1162,4,1166,0.11,S2224
24,AMBIVENKATESAN,Independent,972,6,978,0.09,S2224
25,DURAI. T,Independent,877,3,880,0.08,S2224
26,SATHYAMURTHY. T,Independent,826,8,834,0.08,S2224
27,VIJAYAKUMAR. P,Independent,797,5,802,0.08,S2224
28,PERIYASAMY. V,Independent,771,3,774,0.07,S2224
29,AKILA. M,Independent,742,5,747,0.07,S2224
30,ROJA RAMANI. S,Anna MGR Dravida Makkal Kalgam,738,39,777,0.07,S2224
31,RAJENDRAN. P,Independent,674,1,675,0.06,S2224
32,MANIKANDARAJ. S,Independent,601,7,608,0.06,S2224
33,MURUGESAN. P,Independent,494,3,497,0.05,S2224
34,JOSEPH. L,Samaniya Makkal Nala Katchi,482,9,491,0.05,S2224
35,MUTHURAJA. T,Independent,428,3,431,0.04,S2224
36,NOTA,None of the Above,13560,289,13849,1.31,S2224
1,NAVASKANI K,Indian Union Muslim League,506690,2974,509664,45.92,S2235
2,PANNEERSELVAM O S/O OTTAKARATHEVAR,Independent,340778,2104,342882,30.89,S2235
3,JEYAPERUMAL P,All India Anna Dravida Munnetra Kazhagam,98757,1023,99780,8.99,S2235
4,DR CHANDRA PRABHA JEYAPAL,Naam Tamilar Katchi,96701,971,97672,8.8,S2235
5,MUVITH KUMAR N,Independent,7901,18,7919,0.71,S2235
6,SENTHILMALLAR K,Independent,6629,198,6827,0.62,S2235
7,SIVASHANKAR N,Independent,6583,10,6593,0.59,S2235
8,KANNADHASAN R,Independent,3485,17,3502,0.32,S2235
9,SELVARAJ G,Puthiya Makkal Tamil Desam Katchi,2943,14,2957,0.27,S2235
10,PANNEERSELVAM O S/O OCHAPPAN,Independent,2939,42,2981,0.27,S2235
11,PANCHAVARNAM V,Independent,2561,11,2572,0.23,S2235
12,PARIRAJAN C,Veerath Thiyagi Viswanathadoss Thozhilalarkal Katchi,2493,4,2497,0.22,S2235
13,PANNIR SELVAM M  S/O MALAIYANDI,Independent,2387,15,2402,0.22,S2235
14,NAWASKHAN,Independent,2301,22,2323,0.21,S2235
15,SIVANANDAM N,Bahujan Samaj Party,1958,56,2014,0.18,S2235
16,PANNEERSELVAM O  S/O  OYYADEVAR,Independent,1920,9,1929,0.17,S2235
17,ABUBAKKAR SITHICK J,Desiya Makkal Sakthi Katchi,1497,21,1518,0.14,S2235
18,MANIVASAGAM S,Bahujan Dravida Party,1392,11,1403,0.13,S2235
19,PANNEERSELVAM O S/O  OYYARAM,Independent,1369,7,1376,0.12,S2235
20,SALEEM,Independent,961,13,974,0.09,S2235
21,SASIKANI K,Independent,896,3,899,0.08,S2235
22,SATHURAGIRI K,Independent,815,12,827,0.07,S2235
23,SIKKANDAR B,Independent,804,19,823,0.07,S2235
24,VIGNESH V,Independent,643,9,652,0.06,S2235
25,PANNERSELVAM O  S/O  OCHATTHEVAR,Independent,564,8,572,0.05,S2235
26,NOTA,None of the Above,6163,132,6295,0.57,S2235
1,SUPRIYA SULE,Nationalist Congress Party – Sharadchandra Pawar,731400,912,732312,51.85,S1335
2,SUNETRA AJITDADA PAWAR,Nationalist Congress Party,573391,588,573979,40.64,S1335
3,MAHESH SITARAM BHAGWAT,Independent,15620,43,15663,1.11,S1335
4,SHAIKH SOYALSHAHA YUNUSSHAHA,Independent,14913,4,14917,1.06,S1335
5,PRIYADARSHANI NANDKUMAR KOKARE,Bahujan Samaj Party,9995,35,10030,0.71,S1335
6,SACHIN SHANKAR AGAWANE,Independent,6633,0,6633,0.47,S1335
7,KAMBLE TRISHALA,Bahujan Samaj Party  (Ambedkar),5032,4,5036,0.36,S1335
8,SUNITA PAWAR,Independent,4150,1,4151,0.29,S1335
9,GAJANAN UTTAM GAWALI (PATIL),Independent,2991,4,2995,0.21,S1335
10,MANOJ BALASAHEB RASAL,Independent,2610,0,2610,0.18,S1335
11,MAHADEV SAHEBRAO KHENGARE - PATIL,Bhartiya Navjawan Sena (Paksha),2412,6,2418,0.17,S1335
12,PRADEEP RAMCHANDRA MANE,Independent,2234,1,2235,0.16,S1335
13,SHIVAJI JAYSING KOKRE,Independent,2161,3,2164,0.15,S1335
14,PROF. NAMDEORAO JADHAV,Independent,2125,9,2134,0.15,S1335
15,RAJENDRA PANDURANG BHOSALE,People’s Union Party,2007,2,2009,0.14,S1335
16,KALYANI SUJITKUMAR WAGHMODE,Independent,1974,1,1975,0.14,S1335
17,DASHRATH NANA RAUT,Bharatiya Praja Surajya Paksha,1828,6,1834,0.13,S1335
18,ANKUSH DNYANESHAWAR PILANE,Independent,1663,0,1663,0.12,S1335
19,SANDIP ABAJI DEOKATE,Independent,1622,2,1624,0.11,S1335
20,DATTATRAY RAMBHAU CHANDARE,Independent,1433,1,1434,0.1,S1335
21,SHAILENDRA ALIAS SANDEEP KARANJAWANE,Independent,1392,0,1392,0.1,S1335
22,SHUBHANGI DHAYGUDE,Independent,1283,9,1292,0.09,S1335
23,DR. SOMNATH ALIAS BALASAHEB ARJUN POL,Independent,1169,0,1169,0.08,S1335
24,ROHIDAS BALASO KONDAKE,Bahujan Republican  Socialist Party,1127,3,1130,0.08,S1335
25,MILIND VITTHAL SHINDE,Independent,1099,0,1099,0.08,S1335
26,SURESHDADA BABURAO VIR,Independent,1012,0,1012,0.07,S1335
27,BAPU PRALHAD PAWAR,Independent,997,1,998,0.07,S1335
28,RAJENDRA MAHADEV BARAKADE,Independent,905,2,907,0.06,S1335
29,UMESH MAHADEV MHETRE,Independent,807,1,808,0.06,S1335
30,SHIVAJI RAMBHAU NANDKHILE,Bharatheeya Jawan Kisan Party,785,4,789,0.06,S1335
31,SHARAD RAM PAWAR,Independent,730,1,731,0.05,S1335
32,LAXMAN RAM KUMBHAR,Dalit Soshit Pichhara Varg  Adhikar Dal,694,2,696,0.05,S1335
33,SHRIDHAR NARAYAN SALVE,Bhim Sena,675,4,679,0.05,S1335
34,BALASO MARUTI DHAPATE,Independent,655,0,655,0.05,S1335
35,VIJAY LAXMAN GHAVALE,Independent,617,3,620,0.04,S1335
36,VISHAL ARUN PAWAR,Independent,553,0,553,0.04,S1335
37,SAVITA BHIMRAO KADALE,Hindustan Janta Party,549,2,551,0.04,S1335
38,VIJAYPRAKASH ANANT KONDEKAR,Independent,301,0,301,0.02,S1335
39,NOTA,None of the Above,9130,21,9151,0.65,S1335
1,SK NURUL ISLAM,All India Trinamool Congress,801542,2220,803762,52.76,S2518
2,REKHA PATRA,Bharatiya Janata Party,468593,1622,470215,30.87,S2518
3,AKHTAR RAHAMAN BISWAS,All India Secular Front,123432,68,123500,8.11,S2518
4,NIRAPADA SARDAR,Communist Party of India  (Marxist),77611,288,77899,5.11,S2518
5,MAFIJUL MOLLA,Independent,11833,0,11833,0.78,S2518
6,PRIYAMA DAS,Independent,6606,14,6620,0.43,S2518
7,MIRAZ MOLLA,Independent,5902,0,5902,0.39,S2518
8,MD ABUL KALAM MOLLA,Bahujan Samaj Party,4451,13,4464,0.29,S2518
9,BIDYUT GAYEN,Independent,3625,9,3634,0.24,S2518
10,IMRAN ALI SARDAR,Bharatheeya Jawan Kisan Party,2548,5,2553,0.17,S2518
11,PIYARUL ISLAM,Independent,2388,3,2391,0.16,S2518
12,SARAVAN SINGH,Independent,2020,1,2021,0.13,S2518
13,DAUD ALI GAZI,Socialist Unity Centre Of India (COMMUNIST),1163,4,1167,0.08,S2518
14,KINKAR KANTI ROY,Independent,1115,3,1118,0.07,S2518
15,BIPUL CHANDRA BISWAS,Mulnibasi Party of India,1070,4,1074,0.07,S2518
16,NOTA,None of the Above,5229,19,5248,0.34,S2518
1,DR. HEMANG JOSHI,Bharatiya Janata Party,865825,7364,873189,72.04,S0620
2,PADHIYAR  JASHPALSINH MAHENDRASINH (BAPU),Indian National Congress,287570,3493,291063,24.01,S0620
3,JADAV AMITKUMAR RAMJIBHAI,Bahujan Samaj Party,7473,56,7529,0.62,S0620
4,RAJESH RATHOD,Independent,5416,53,5469,0.45,S0620
5,ANILBHAI SHARMA,Hindrashtra Sangh,3436,17,3453,0.28,S0620
6,DR. RAHUL VASUDEVBHAI VYAS,Independent,2731,21,2752,0.23,S0620
7,PARMAR MAYURSINH ARVINDSINH,Independent,2122,86,2208,0.18,S0620
8,NILKANTHKUMAR MANSUKHLAL MISTRI,Independent,1748,8,1756,0.14,S0620
9,PARMAR HEMANTKUMAR ARVINDBHAI,Independent,1388,23,1411,0.12,S0620
10,TAPAN DASGUPTA,Socialist Unity Centre Of India (COMMUNIST),1252,23,1275,0.11,S0620
11,ATUL GAMECHI,Independent,1061,23,1084,0.09,S0620
12,PARTHIV VIJAYKUMAR DAVE,Right to Recall Party,1052,5,1057,0.09,S0620
13,NILESH JAGANNATH VASAIKAR,Independent,840,18,858,0.07,S0620
14,DOSHI HARDIK BIPINBHAI,Satyawadi Rakshak Party,643,14,657,0.05,S0620
15,NOTA,None of the Above,17823,565,18388,1.52,S0620
1,TEJASVI SURYA,Bharatiya Janata Party,747780,3050,750830,60.1,S1026
2,SOWMYA REDDY,Indian National Congress,472754,993,473747,37.92,S1026
3,ARUN PRASAD.A,Bahujan Samaj Party,2416,9,2425,0.19,S1026
4,TINTISHA HEMACHANDRA SAGAR,Independent,1962,6,1968,0.16,S1026
5,VATAL NAGARAJ,Kannada Chalavali Vatal Paksha,1857,10,1867,0.15,S1026
6,KEMPEGOWDA,Navabharath Sena,1390,3,1393,0.11,S1026
7,TEJASWINI DHANANJAY,Independent,1147,3,1150,0.09,S1026
8,BALAKRISHNA.M.,Uttama Prajaakeeya Party,1106,4,1110,0.09,S1026
9,JAYAPAL.D,Independent,940,2,942,0.08,S1026
10,RANJITH GOWDA,Independent,859,1,860,0.07,S1026
11,V.RAJKUMAR VCK,Independent,738,2,740,0.06,S1026
12,RAGHUPATHI BHAT,Karnataka Rashtra Samithi,737,1,738,0.06,S1026
13,DR HARISH GOWDA,Independent,555,8,563,0.05,S1026
14,CHETAN CHAMAN,Country Citizen Party,490,2,492,0.04,S1026
15,A . RAJ.,Independent,473,4,477,0.04,S1026
16,K. C. JANARDHAN,Independent,444,8,452,0.04,S1026
17,KANTHAKUMAR.R.,Independent,393,10,403,0.03,S1026
18,KARAVALI MANJUNATH. BE,Rashtriya Samaj Dal (R),308,2,310,0.02,S1026
19,C M. SHABAZ KHAN,Young Star Empowerment Party,295,2,297,0.02,S1026
20,ASGAR A MOHIN.S.M.,Independent,266,3,269,0.02,S1026
21,SUBRAHMANYA KUMAR KUNTIKANAMATA,Independent,234,3,237,0.02,S1026
22,DR.R.SHEKAR THIRUMAVALVAN,Independent,214,1,215,0.02,S1026
23,NOTA,None of the Above,7830,27,7857,0.63,S1026
1,DR. AMOL RAMSING KOLHE,Nationalist Congress Party – Sharadchandra Pawar,697768,924,698692,50.83,S1336
2,ADHALRAO SHIVAJI DATTATREY,Nationalist Congress Party,557138,603,557741,40.58,S1336
3,MANOHAR MAHADU WADEKAR,Independent,28324,6,28330,2.06,S1336
4,DR. ANWAR SHAIKH,Vanchit Bahujan  Aaghadi,17444,18,17462,1.27,S1336
5,RAHUL RAGHUNATH OWHAL,Bahujan Samaj Party,10280,15,10295,0.75,S1336
6,CHANDGUDE VINOD VASANT,Independent,8076,2,8078,0.59,S1336
7,GORAKSH KASABE,Independent,4913,2,4915,0.36,S1336
8,ADV. DR. LAXMAN RAMBHAU DAMSE,Bharat Adivasi Party,4125,11,4136,0.3,S1336
9,GAIKWAD NILOBA CHANGADEO,Independent,3569,2,3571,0.26,S1336
10,UMESH MAHADEV MHETRE,Independent,3499,0,3499,0.25,S1336
11,ADV.SWAPNIL BHAUSAHEB SHELAR,Independent,2667,0,2667,0.19,S1336
12,AMOL VILAS PACHUNDKAR,Independent,2386,2,2388,0.17,S1336
13,ASLAM ISAK BAGWAN,Lok Sena Party,2348,2,2350,0.17,S1336
14,KAMBLE TRIMBAK NARAYAN,Baliraja Party,2223,4,2227,0.16,S1336
15,SUBASH KASHINATH SARODE,Independent,2161,0,2161,0.16,S1336
16,CHAAYA SANJAY JAGDALE-SOLANKE,Independent,1823,7,1830,0.13,S1336
17,SUSHIL DNYANDEV KANSE,Independent,1731,1,1732,0.13,S1336
18,NARAYAN PRABHAKAR ANKUSHE,Bharatheeya Jawan Kisan Party,1279,5,1284,0.09,S1336
19,BHOR VIKAS ROHIDAS,Independent,1145,2,1147,0.08,S1336
20,DADA ALIAS VIKAS SURESH KASBE,Independent,1105,1,1106,0.08,S1336
21,SURAJ CHANDRAKANT GAIKWAD,Independent,936,2,938,0.07,S1336
22,SWAPNIL DHANAJI LONDHE,Bhim Sena,913,1,914,0.07,S1336
23,AMAR MACHINDRA BORHADE,Independent,887,1,888,0.06,S1336
24,RAVINDRA MOTIRAM SIRSAM,Independent,870,0,870,0.06,S1336
25,TUKARAM NAMDEO DAPHAL,Sainik Samaj Party,862,20,882,0.06,S1336
26,PANDURANG BHAGWAN WAGHOLE,Independent,818,1,819,0.06,S1336
27,SANJAY LAXMAN PADWAL,Bhartiya Navjawan Sena (Paksha),779,5,784,0.06,S1336
28,HARIDAS CHANDAR BHISE,Bharatiya Lokvikas Party,721,2,723,0.05,S1336
29,SALIM BABA SAYYAD,Independent,671,0,671,0.05,S1336
30,PRAKASH SUKHADEO JAMDHADE,Independent,602,1,603,0.04,S1336
31,WAKHARE PRADIP PANDURANG,Independent,574,0,574,0.04,S1336
32,RAHUL ARJUN HORE,Independent,526,0,526,0.04,S1336
33,NOTA,None of the Above,9634,27,9661,0.7,S1336
1,KAUSHALENDRA KUMAR,Janata Dal  (United),557054,2368,559422,48.88,S0429
2,DR. SANDEEP SAURAV,Communist Party of India  (Marxist-Leninist)  (Liberation),388052,2256,390308,34.11,S0429
3,SUDHIR KUMAR,Sanyukt Kisan Vikas Party,25286,5,25291,2.21,S0429
4,SURENDRA PRASAD,Al-Hind Party,18571,5,18576,1.62,S0429
5,SHASHI KUMAR,Samaj Shakti Party,18472,8,18480,1.61,S0429
6,PRAMOD KUMAR NIRALA,Bahujan Samaj Party,15233,99,15332,1.34,S0429
7,AJEET KUMAR,Independent,14746,4,14750,1.29,S0429
8,VINAY PRATAP SINGH,Rashtriya Sanatan Party,9593,9,9602,0.84,S0429
9,SANJAY RAJESH,Karpoori Janta Dal,7878,9,7887,0.69,S0429
10,SUDHIR DAS,Independent,6804,2,6806,0.59,S0429
11,KANHAIYA LAL YADAV,Jagrook Janta Party,6665,27,6692,0.58,S0429
12,SANYUKTA KUMARI,Independent,6232,6,6238,0.55,S0429
13,AJIT KUMAR,Independent,5515,5,5520,0.48,S0429
14,SHYAM SUNDAR PRASAD,Independent,3922,10,3932,0.34,S0429
15,RAMESH KUMAR,Naki Bharatiya Ekta Party,3840,5,3845,0.34,S0429
16,KISLAY KUMAR,Independent,3599,3,3602,0.31,S0429
17,KESHO JAMADAR,Peoples Party of India (Democratic),3369,18,3387,0.3,S0429
18,SURENDER SINGH,Independent,3341,4,3345,0.29,S0429
19,DILIP KUMAR,Moolniwasi Samaj Party,2724,5,2729,0.24,S0429
20,NAND KISHOR PARASAD,Pragatisheel Magahi Samaj,2456,12,2468,0.22,S0429
21,NISHA RANJAN,Samata Party,2397,18,2415,0.21,S0429
22,SHASHIRANJAN SUMAN,Independent,2331,9,2340,0.2,S0429
23,GHANSHYAM PRASAD SINGH,Independent,2108,2,2110,0.18,S0429
24,KUMAR HARI CHARAN SINGH YADAV,Bharatiya Momin Front,1971,9,1980,0.17,S0429
25,MUNNA KUMAR,Sankhyanupati Bhagidari Party,1937,12,1949,0.17,S0429
26,MUNNA KUMAR,Samajwadi Lok Parishad,1867,13,1880,0.16,S0429
27,PAWAN KUMAR,Independent,1595,2,1597,0.14,S0429
28,PUJA DEVI,Independent,1491,14,1505,0.13,S0429
29,CHANDRA KISHOR PRASAD YADAV,Independent,1177,1,1178,0.1,S0429
30,NOTA,None of the Above,19110,107,19217,1.68,S0429
1,DR. LATA WANKHEDE,Bharatiya Janata Party,786160,1819,787979,68.49,S125
2,CHANDRA BHUSAN SINGH BUNDELA 'GUDDU RAJA',Indian National Congress,316059,698,316757,27.53,S125
3,BHAGWATI PRASAD JATAV,Bahujan Samaj Party,16592,44,16636,1.45,S125
4,BHEEKAM SINGH KUSHWAHA,Mahanwadi Party,5778,6,5784,0.5,S125
5,RAM BHJAN BANSAL,Samata Party,3149,4,3153,0.27,S125
6,MOHAMAD AARIF MAKRANI,Independent,2888,0,2888,0.25,S125
7,SANGRAM SINGH YADAV,Independent,2819,5,2824,0.25,S125
8,DHARMENDRA BANPURIYA,Independent,1621,3,1624,0.14,S125
9,TOSHMANI PANTHI (KANNA),Independent,1293,6,1299,0.11,S125
10,SURESH BANSAL,Bhartiya Shakti Chetna Party,1147,4,1151,0.1,S125
11,LAXMI KUSHWAHA,Pichhara Samaj Party United,947,5,952,0.08,S125
12,DR. RAMAVATAR SHARMA,Socialist Unity Centre Of India (COMMUNIST),924,4,928,0.08,S125
13,AHIRWAR RAJKUMAR THEKEDAAR,Independent,914,3,917,0.08,S125
14,NOTA,None of the Above,7641,16,7657,0.67,S125
1,NALIN SOREN,Jharkhand Mukti Morcha,542299,5071,547370,46.23,S272
2,SITA MURMU,Bharatiya Janata Party,520714,4129,524843,44.32,S272
3,MAHASHON MURMU,Independent,21371,1,21372,1.8,S272
4,BABYLATA TUDU,Independent,19275,85,19360,1.63,S272
5,RAJESH KISKU,Communist Party of India,11484,22,11506,0.97,S272
6,DR. SRILAL KISKU,Independent,9414,2,9416,0.8,S272
7,PARESH MARANDI,Bahujan Samaj Party,7713,20,7733,0.65,S272
8,ANIL TUDU,Lokhit Adhikar Party,6811,7,6818,0.58,S272
9,SUSHANTI HEMBROM,Independent,5150,2,5152,0.44,S272
10,MANOJ HEMBROM,Independent,4814,2,4816,0.41,S272
11,BIREN MOHLI,Independent,4416,2,4418,0.37,S272
12,RAJU EMANUEL MURMU,Ambedkarite Party of India,3056,4,3060,0.26,S272
13,KAMISHNAR MURMU,Independent,2509,7,2516,0.21,S272
14,BAGHRAI SOREN,Independent,2255,1,2256,0.19,S272
15,SANJAY TUDU,Independent,2171,3,2174,0.18,S272
16,MUNNI HANSDA,Samata Party,1753,5,1758,0.15,S272
17,NIRMAL SOREN,Independent,1707,6,1713,0.14,S272
18,ALESH HANSDA,Indian National Socialistic Action Forces,1666,8,1674,0.14,S272
19,JONATHAN MARDI,Peoples Party of India (Democratic),1650,1,1651,0.14,S272
20,NOTA,None of the Above,4453,73,4526,0.38,S272
1,RAKESH RATHOR,Indian National Congress,530467,671,531138,48.2,S2430
2,RAJESH VERMA,Bharatiya Janata Party,441066,431,441497,40.06,S2430
3,MAHENDRA SINGH YADAV,Bahujan Samaj Party,99284,80,99364,9.02,S2430
4,MO. KASHIF ANSARI,Apna Dal (Kamerawadi),7585,1,7586,0.69,S2430
5,LEKHRAJ LODHI,Aazad Samaj Party (Kanshi Ram),6734,0,6734,0.61,S2430
6,VIDYAWATI GAUTAM,Independent,4193,1,4194,0.38,S2430
7,CHANDRA SHEKHAR VERMA,Rashtriya Shoshit Samaj Party,2429,0,2429,0.22,S2430
8,RAM ADHAR VERMA,Sardar Patel Siddhant Party,2114,1,2115,0.19,S2430
9,NOTA,None of the Above,6954,4,6958,0.63,S2430
1,DR RAJEEV BHARDWAJ,Bharatiya Janata Party,622482,10311,632793,61.03,S081
2,ANAND SHARMA,Indian National Congress,374346,6552,380898,36.74,S081
3,REKHA CHAUDHARY,Bahujan Samaj Party,7478,275,7753,0.75,S081
4,ADVOCATE SANJAY SHARMA,Independent,2304,15,2319,0.22,S081
5,DR KEHAR SINGH,Independent,2129,49,2178,0.21,S081
6,JEEVAN KUMAR,Akhil Bhartiya Parivar Party,1441,35,1476,0.14,S081
7,NARAIN SINGH DOGRA,Himachal Janta Party,1125,46,1171,0.11,S081
8,BHUVNESH KUMAR,Rashtriya Devbhumi Party,701,55,756,0.07,S081
9,DEV RAJ BHARDWAJ,Rashtriya Samaj Dal (R),588,19,607,0.06,S081
10,ACHAL SINGH,Independent,491,54,545,0.05,S081
11,NOTA,None of the Above,6260,112,6372,0.61,S081
1,SMT. HIMADRI SINGH,Bharatiya Janata Party,709477,1666,711143,61.73,S1212
2,PHUNDE LAL SINGH MARKO,Indian National Congress,312833,970,313803,27.24,S1212
3,ANIL SINGH DHURVEY,Gondvana Gantantra Party,35186,92,35278,3.06,S1212
4,DHANI RAM KOL,Bahujan Samaj Party,21792,62,21854,1.9,S1212
5,SAMAR SHAH SINGH GOND,Communist Party of India,19861,22,19883,1.73,S1212
6,KESHKALI BAIGA,Independent,10042,29,10071,0.87,S1212
7,GUNJAN SINGH,Independent,7460,19,7479,0.65,S1212
8,RAVIKARAN SINGH DHURVE,Bhartiya Shakti Chetna Party,4964,11,4975,0.43,S1212
9,AMRIT LAL SINGH UIKEY,Peoples Party of India (Democratic),4701,21,4722,0.41,S1212
10,DR. DURGA WATI BHARIA,Chhattisgarh Vikas Ganga Rashtriya Party,3425,19,3444,0.3,S1212
11,NOTA,None of the Above,19341,20,19361,1.68,S1212
1,BALYA MAMA - SURESH GOPINATH MHATRE,Nationalist Congress Party – Sharadchandra Pawar,498199,1265,499464,39.85,S1323
2,KAPIL MORESHWAR PATIL,Bharatiya Janata Party,431907,1436,433343,34.57,S1323
3,NILESH BHAGWAN SAMBARE,Independent,230254,1163,231417,18.46,S1323
4,KANCHAN VINAYAK VAKHARE,New Rashtriya Samaj Party,24607,18,24625,1.96,S1323
5,TARA PINTYA WAGHE,Independent,6908,0,6908,0.55,S1323
6,MUMATAZ ABDULSATTAR ANSARI,Bahujan Samaj Party,6801,21,6822,0.54,S1323
7,MANISHA SANTOSH GONDHALE,Independent,5120,0,5120,0.41,S1323
8,MANOJ GOVAR TURE,Independent,4896,1,4897,0.39,S1323
9,JAHID MURABTAR ANSARI,Independent,4879,3,4882,0.39,S1323
10,CHANDRAKANT RAMBHAJI MOTE,Independent,3429,4,3433,0.27,S1323
11,RAHUL ASHOK KATHOLE,Independent,3131,4,3135,0.25,S1323
12,ASHOK BHIKU BAHADARE,Sanyukt Bharat Paksh,2044,3,2047,0.16,S1323
13,SURESH PANDAGALE,Apni Prajahit Party,1997,16,2013,0.16,S1323
14,MILIND KASHINATH KAMBLE,Independent,1843,18,1861,0.15,S1323
15,KHAN MOHD AKARAM ABDUL HANAN,All India Majlis-E-Ittehadul Muslimeen,1739,2,1741,0.14,S1323
16,DANISH EZAZ AH. SHAIKH,Bahujan Maha Party,1580,6,1586,0.13,S1323
17,HARSHAD RAMESH MHATRE,Independent,1568,0,1568,0.13,S1323
18,MUTKIRI SHANKAR NAGESH,Independent,1445,0,1445,0.12,S1323
19,KAPIL JAYHIND PATIL,Independent,1237,5,1242,0.1,S1323
20,SAIFAN CHAND PATHAN,Bhartiya Manavta Party,1188,1,1189,0.09,S1323
21,RANJANA RAVI TRIBHUWAN,Independent,1082,3,1085,0.09,S1323
22,MOHD. KALEEM ANSARI,Peoples Party of India (Democratic),934,3,937,0.07,S1323
23,WASEEM TUFAIL SIDDIQUI,Independent,803,2,805,0.06,S1323
24,SURESH SITARAM MHATRE,Independent,706,1,707,0.06,S1323
25,SONALI ASHOK GANGAWANE,Independent,698,0,698,0.06,S1323
26,AAPPA - VISHAL VIJAY MORE,Independent,598,3,601,0.05,S1323
27,PROF. AMEERUL HASAN SAYYED,Independent,479,2,481,0.04,S1323
28,NOTA,None of the Above,9266,81,9347,0.75,S1323
1,PRALHAD JOSHI,Bharatiya Janata Party,713649,2582,716231,52.41,S1011
2,VINOD ASOOTI,Indian National Congress,617616,1291,618907,45.29,S1011
3,SHAKEELAHMAD.D.MULLA,Independent,5866,6,5872,0.43,S1011
4,S. S. PATIL,Independent,5153,8,5161,0.38,S1011
5,RAJU ANANTSA NAIKWADI,Independent,3601,0,3601,0.26,S1011
6,JAVEED AHAMED BELGAUMKAR.,Naki Bharatiya Ekta Party,3551,7,3558,0.26,S1011
7,SHARANABASAV GONAVAR,Socialist Unity Centre Of India (COMMUNIST),1148,19,1167,0.09,S1011
8,BALANAGOUDRA MALLIKARJUNAGOUDA,Independent,986,1,987,0.07,S1011
9,TAKAPPA YALLAPPA KALAL,Prahar Janshakti Party,901,4,905,0.07,S1011
10,BUGADI BASAVALINGAPPA IRAPPA,Uttama Prajaakeeya Party,796,4,800,0.06,S1011
11,NAGARAJ. KARENNAVAR.,Karnataka Rashtra Samithi,553,2,555,0.04,S1011
12,PRAVEEN H. H.,Independent,545,3,548,0.04,S1011
13,DR. GURAPPA H IMRAPUR,Independent,510,4,514,0.04,S1011
14,BANKAPUR SHOUKATALI,Tipu Sultan Party,464,9,473,0.03,S1011
15,VINOD DASHARATH GHODKE,"Proutist Bloc, India",409,2,411,0.03,S1011
16,VENKATESH PRASAD. H,Indian Labour Party (Ambedkar Phule),334,3,337,0.02,S1011
17,MOHAMMED ISMAIL MUKTI,Bharatiya Prajagala Kalyana Paksha,313,4,317,0.02,S1011
18,NOTA,None of the Above,6126,21,6147,0.45,S1011
1,DULU MAHATO,Bharatiya Janata Party,782423,6749,789172,55.26,S277
2,ANUPAMA SINGH,Indian National Congress,452358,5231,457589,32.04,S277
3,MD. EKLAK ANSARI,Independent,78885,768,79653,5.58,S277
4,JAGDISH RAWANI,Independent,27499,136,27635,1.94,S277
5,JANAK SAH GOND,Independent,12761,3,12764,0.89,S277
6,MD. ZAHIRUDDIN KHAN,Independent,6499,1,6500,0.46,S277
7,MOHAN SINGH,Bahujan Samaj Party,5594,45,5639,0.39,S277
8,TULSI MAHTO,Independent,5371,4,5375,0.38,S277
9,KAMASHEVAR PRA. VERMA,Independent,4002,2,4004,0.28,S277
10,SUNAINA KINNAR,Independent,3430,32,3462,0.24,S277
11,AKBAR ALI,Akhil Bhartiya Parivar Party,3031,10,3041,0.21,S277
12,KRISHNA CHANDRA SINGH RAJ,Samata Party,2818,3,2821,0.2,S277
13,ANINDITA DAS,Independent,2655,19,2674,0.19,S277
14,REZAUL HAQUE,Lokhit Adhikar Party,2642,7,2649,0.19,S277
15,LAKSHMI DEVI,Independent,2600,5,2605,0.18,S277
16,UMESH PASWAN,Independent,2554,6,2560,0.18,S277
17,MOHAMMAD FAISHAL KHAN,Independent,1994,2,1996,0.14,S277
18,RAJIB TIWARI,Socialist Unity Centre Of India (COMMUNIST),1880,10,1890,0.13,S277
19,DEEPAK KUMAR DAS,Peoples Party of India (Democratic),1720,15,1735,0.12,S277
20,NITAI DUTTA,Independent,1695,48,1743,0.12,S277
21,SANJAY KUMAR GIRI,Akhil Bharat Hindu Mahasabha,1617,10,1627,0.11,S277
22,PERWEZ NEYYAR,Aazad Samaj Party (Kanshi Ram),1157,4,1161,0.08,S277
23,TRIDEV KR MAHTO,Independent,1126,18,1144,0.08,S277
24,MOHAMMAD TAFAZUL HUSSAIN,Independent,681,0,681,0.05,S277
25,PREM PRAKASH PASWAN,Independent,516,17,533,0.04,S277
26,NOTA,None of the Above,7202,152,7354,0.51,S277
1,PRATAP CHANDRA SARANGI,Bharatiya Janata Party,561590,2275,563865,45.49,S186
2,LEKHASRI SAMANTSINGHAR,Biju Janata Dal,415917,792,416709,33.62,S186
3,SHRIKANTA JENA,Indian National Congress,236081,926,237007,19.12,S186
4,RAJAT KUMAR BEHERA,Bahujan Samaj Party,2913,7,2920,0.24,S186
5,GOBINDA CHANDRA BHOI,National Apni Party,2640,0,2640,0.21,S186
6,SURYAKANTA DASMOHAPATRA,Independent,2156,5,2161,0.17,S186
7,MAHAMEGHABAHAN AIRA KHARABELA SWAIN,Independent,1863,5,1868,0.15,S186
8,PRAMOD KUMAR PATTAYAT,Independent,1637,2,1639,0.13,S186
9,BIREN PUHAN,Krupaa Party,1450,2,1452,0.12,S186
10,DEEPAK SANKAR THAKUR GIRI,Independent,1191,3,1194,0.1,S186
11,AKHIL KUMAR MOHANTA,Independent,829,1,830,0.07,S186
12,NOTA,None of the Above,7333,17,7350,0.59,S186
1,CHINTAMANI MAHARAJ,Bharatiya Janata Party,712172,1028,713200,49.01,S261
2,SHASHI SINGH KORAM,Indian National Congress,647329,1049,648378,44.55,S261
3,DR. L. S. UDAY SINGH,Gondvana Gantantra Party,15626,25,15651,1.08,S261
4,SANJAY KUMAR,Bahujan Samaj Party,15182,17,15199,1.04,S261
5,RAMADHAR SINGH,Independent,10857,4,10861,0.75,S261
6,PRINCE ABHISHEK KUJUR,Independent,6803,12,6815,0.47,S261
7,URMILA SINGH,Independent,5779,5,5784,0.4,S261
8,ARVIND KACHHAP,Independent,4166,18,4184,0.29,S261
9,KANTA MINJ,Akhil Bhartiya Parivar Party,4008,8,4016,0.28,S261
10,JEROME MINJ,Bharat Adivasi Party,3035,25,3060,0.21,S261
11,NOTA,None of the Above,28107,14,28121,1.93,S261
1,RAJEEV RAI,Samajwadi Party,501407,1724,503131,43.73,S2470
2,DR. ARVIND RAJBHAR,Suheldev Bharatiya Samaj Party,339416,772,340188,29.57,S2470
3,BALKRISHNA CHAUHAN,Bahujan Samaj Party,208938,466,209404,18.2,S2470
4,LILAWATI RAJBHAR,Moolniwasi Samaj Party,47520,7,47527,4.13,S2470
5,PAWAN KUMAR CHAUHAN,Independent,7067,10,7077,0.62,S2470
6,VINOD KUMAR RAI,Communist Party of India,6987,6,6993,0.61,S2470
7,ROLI GUPTA,Akhil Bhartiya Hamara Samaj Party,4211,14,4225,0.37,S2470
8,VIRENDRA,Rashtriya Jantantrik Bharat Vikas Party,2344,3,2347,0.2,S2470
9,VIJAY,Socialist Unity Centre Of India (COMMUNIST),2240,1,2241,0.19,S2470
10,AWADHESH KUMAR CHAUHAN,Janta Kranti Party (Rashtravadi),2211,28,2239,0.19,S2470
11,SATISH CHAND PRAJAPATI FAUJI,Samajhdar Party,1918,3,1921,0.17,S2470
12,MADAN RAJBHAR,Mang Samaj Party,1895,10,1905,0.17,S2470
13,SAUDAGER,Independent,1892,0,1892,0.16,S2470
14,RAJENDRA RAM,Independent,1649,0,1649,0.14,S2470
15,YAKUB ANSARI,Peace Party,1568,5,1573,0.14,S2470
16,PREM CHAND,Pragatisheel Manav Samaj Party,1559,2,1561,0.14,S2470
17,SANTOSH KUMAR GUPTA,Janlok Vikas Party,1473,0,1473,0.13,S2470
18,JYOTIRMA PATHAK,Independent,1199,5,1204,0.1,S2470
19,BADRI NATH,Independent,1164,6,1170,0.1,S2470
20,PREMCHAND NAYAK,Independent,1116,1,1117,0.1,S2470
21,RAMNARESH YADAV,Jan Raajya Party,881,4,885,0.08,S2470
22,RAJIV KUMAR SINGH,Independent,855,2,857,0.07,S2470
23,ISHWAR DAYAL SINGH SETH,Bhartiya Sabka Dal,827,14,841,0.07,S2470
24,PRAGYESH KUMAR,Independent,816,2,818,0.07,S2470
25,RAMVACHAN,Sardar Patel Siddhant Party,771,2,773,0.07,S2470
26,RAJENDRA AGRAWAL,Independent,729,1,730,0.06,S2470
27,GOPAL SINGH,Azad Adhikar Sena,729,8,737,0.06,S2470
28,ISMAIL ANSARI,Aawami Pichhada Party,592,2,594,0.05,S2470
29,NOTA,None of the Above,3487,31,3518,0.31,S2470
1,JASHUBHAI BHILUBHAI RATHVA,Bharatiya Janata Party,791727,4862,796589,62.84,S0621
2,SUKHRAMBHAI HARIYABHAI RATHWA,Indian National Congress,394433,3379,397812,31.38,S0621
3,BHIL SOMABHAI GOKALBHAI,Bahujan Samaj Party,16021,72,16093,1.27,S0621
4,RATHVA FURAKANBHAI BALJIBHAI,Malwa Congress,11091,70,11161,0.88,S0621
5,TADVI RANCHHODBHAI,Bharatiya Bahujan Congress,8292,52,8344,0.66,S0621
6,RATHVA MUKESHBHAI NURABHAI,Independent,8032,33,8065,0.64,S0621
7,NOTA,None of the Above,29394,261,29655,2.34,S0621
1,T R BAALU,Dravida Munnetra Kazhagam,755671,2940,758611,52.65,S225
2,G PREMKUMAR,All India Anna Dravida Munnetra Kazhagam,270549,1033,271582,18.85,S225
3,V N VENUGOPAL,Tamil Maanila Congress  (Moopanar),209183,927,210110,14.58,S225
4,V RAVICHANDRAN,Naam Tamilar Katchi,139931,302,140233,9.73,S225
5,K PRABAKARAN,Bahujan Samaj Party,8115,74,8189,0.57,S225
6,M S ARUMUGAM,Independent,3695,4,3699,0.26,S225
7,V SUDHAVALLI,Aravor Munnetra Kazhagam,3659,35,3694,0.26,S225
8,S AMBETHKUMAR,Mahathma Makkal Munnetra Kazhakam,2211,9,2220,0.15,S225
9,M ASHOK KUMAR,Independent,1696,8,1704,0.12,S225
10,S SIVAKUMAR,Veerath Thiyagi Viswanathadoss Thozhilalarkal Katchi,1349,3,1352,0.09,S225
11,AYODHI LAKSHMANAN,Independent,1255,4,1259,0.09,S225
12,S CHITTIBABU,Naadaalum Makkal Katchi,1238,3,1241,0.09,S225
13,C ARAVIND,Desiya Makkal Sakthi Katchi,959,11,970,0.07,S225
14,GOPI DEEPAK,Independent,878,5,883,0.06,S225
15,KARTHIK KUMAR P C,Independent,866,1,867,0.06,S225
16,J MOHANRAJ,Jebamani Janata,817,5,822,0.06,S225
17,DR S PRAVEEN,Independent,791,8,799,0.06,S225
18,I MOHAMED YASEEN,Thakkam Katchi,668,1,669,0.05,S225
19,K PALANIYAPPAN,Tamizhaga Murpokku Makkal Katchi,613,4,617,0.04,S225
20,S PRABHU,Independent,513,1,514,0.04,S225
21,P BASKARAN,Independent,493,1,494,0.03,S225
22,P HARIDAS,Independent,458,2,460,0.03,S225
23,C A JAYARAMAN,Independent,445,2,447,0.03,S225
24,G RAMKUMAR,Independent,426,0,426,0.03,S225
25,N MANIKKAM,Independent,402,1,403,0.03,S225
26,M PREMKUMAR,Independent,393,1,394,0.03,S225
27,S MUNIKUMAR,Samaniya Makkal Nala Katchi,393,1,394,0.03,S225
28,M SARAVANAN,Independent,385,0,385,0.03,S225
29,A JINNA MOHAMMED,Independent,382,6,388,0.03,S225
30,S SIVARAMAN,Independent,340,3,343,0.02,S225
31,C PREMKUMAR,Independent,313,3,316,0.02,S225
32,NOTA,None of the Above,26294,156,26450,1.84,S225
1,OMPRAKASH BHUPALSINH ALIAS PAVAN RAJENIMBALKAR,Shiv Sena (Uddhav Balasaheb Thackrey),743597,5155,748752,58.45,S1340
2,ARCHANA RANAJAGJITSINH PATIL,Nationalist Congress Party,416699,2207,418906,32.7,S1340
3,ANDHALKAR BHAUSAHEB RAOSAHEB,Vanchit Bahujan  Aaghadi,33221,181,33402,2.61,S1340
4,GOVARDHAN SUBRAO NIMBALKAR,Independent,18947,19,18966,1.48,S1340
5,DNYANESHWAR NAGANATHRAO KOLI,Samata Party,6459,13,6472,0.51,S1340
6,KAKASAHEB SANDIPAN KHOT,Independent,5707,8,5715,0.45,S1340
7,SANJAYKUMAR BHAGWAT WAGHMARE,Bahujan Samaj Party,5525,90,5615,0.44,S1340
8,KAKA FULCHAND KAMBLE,Independent,4807,4,4811,0.38,S1340
9,RAM HANUMANT SHENDAGE,Independent,3255,8,3263,0.25,S1340
10,UMAJI PANDURANG GAIKWAD,Independent,3089,6,3095,0.24,S1340
11,GORE NETAJI NAGNATH,Desh Janhit Party,2314,22,2336,0.18,S1340
12,HANUMANT LAXMAN BONDAR,Independent,2170,2,2172,0.17,S1340
13,NAVNATH DASHRATH UPALEKAR,Independent,2099,9,2108,0.16,S1340
14,SIDDIK IBRAHIM BAUDIWALE ALIAS GOLABHAI,All India Majlis-E-Ittehadul Muslimeen,2052,8,2060,0.16,S1340
15,ARJUN (DADA) SALGAR,Independent,1923,12,1935,0.15,S1340
16,ARYANRAJE KISANRAO SHINDE,Rashtriya Samaj Dal (R),1852,35,1887,0.15,S1340
17,SHAIKH NAUSHAD IQBAL,Swarajya Shakti Sena,1671,15,1686,0.13,S1340
18,SHAMRAO HARIBHAU PAWAR,Samnak Janta Party,1492,17,1509,0.12,S1340
19,YOGIRAJ ANANTA TAMBE,Independent,1326,10,1336,0.1,S1340
20,SOMNATH NANASAHEB KAMBLE,Independent,1262,6,1268,0.1,S1340
21,BHORE NITIN KHANDU,Independent,1195,9,1204,0.09,S1340
22,MANOHAR ANANDRAO PATIL,Independent,1182,8,1190,0.09,S1340
23,NAVNATH VISHWANATH DUDHAL,Vishva Shakti Party,1123,12,1135,0.09,S1340
24,NITESH SHIVAJI PAWAR,Hindrashtra Sangh,1060,19,1079,0.08,S1340
25,ADV. VISHVJEET VIJAYKUMAR SHINDE,Aadarsh Sangram Party,855,10,865,0.07,S1340
26,SHAYANI NAVANATH JADHAV,Independent,779,3,782,0.06,S1340
27,NITIN NAGNATH GAIKWAD,Independent,729,2,731,0.06,S1340
28,ADV. BHAUSAHEB ANIL BELURE,Independent,675,2,677,0.05,S1340
29,VILAS BHAGWAT GHADGE,Independent,604,6,610,0.05,S1340
30,SAMEERSINGH RAMESHCHANDRA SALVI,Independent,591,3,594,0.05,S1340
31,RAJKUMAR SAHEBRAO PATIL,Independent,589,4,593,0.05,S1340
32,NOTA,None of the Above,4250,48,4298,0.34,S1340
1,BRIJENDRA SINGH OLA,Indian National Congress,541203,11965,553168,49.44,S204
2,SHUBHKARAN CHOUDHARY,Bharatiya Janata Party,523669,11264,534933,47.81,S204
3,SHEKHAWAT RAJENDRA SINGH,Independent,7389,301,7690,0.69,S204
4,BANSHIDHAR,Bahujan Samaj Party,6679,188,6867,0.61,S204
5,DURGA PRASAD MEENA,Ambedkarite Party of India,5440,57,5497,0.49,S204
6,ALTIF,Independent,2025,25,2050,0.18,S204
7,SATYANARAYAN,Bheem Tribal Congress,1127,23,1150,0.1,S204
8,HAZARI LAL,Bahujan Kranti Party (Marxwad-Ambedkarwad),922,18,940,0.08,S204
9,NOTA,None of the Above,6454,178,6632,0.59,S204
1,ASHOK KUMAR YADAV,Bharatiya Janata Party,552705,723,553428,53.85,S046
2,MD ALI ASHRAF FATMI,Rashtriya Janata Dal,400909,574,401483,39.07,S046
3,SHIV BODHAN SAHU,Independent,13365,5,13370,1.3,S046
4,BIKASH KUMAR,Bahujan Samaj Party,7197,26,7223,0.7,S046
5,PRIYE RANJAN,Independent,7046,4,7050,0.69,S046
6,VAIDYANATH YADAV,Peoples Party of India (Democratic),4980,3,4983,0.48,S046
7,SARFARAJ ALAM,Akhil Bhartiya Parivar Party,4620,3,4623,0.45,S046
8,MD WAQUAR SIDDIQUI,All India Majlis-E-Ittehadul Muslimeen,4492,6,4498,0.44,S046
9,MOHAN SHARMA,Rashtriya Jansambhavna Party,4460,4,4464,0.43,S046
10,ABU BAKAR RAHMANI,Country Citizen Party,2095,2,2097,0.2,S046
11,UDAY MANDAL,Samata Party,1998,9,2007,0.2,S046
12,KUL BHUSHAN PRASAD,Loktantrik Lok Rajyam Party,1780,3,1783,0.17,S046
13,NOTA,None of the Above,20691,28,20719,2.02,S046
1,DR BHOLA SINGH,Bharatiya Janata Party,594040,3270,597310,56.65,S2414
2,SHIVRAM,Indian National Congress,321043,1133,322176,30.56,S2414
3,GIRISH CHANDRA,Bahujan Samaj Party,116876,548,117424,11.14,S2414
4,RAJESH TUREHA,Rishivadi Karm Sheel Young Parmarthi Party,4391,10,4401,0.42,S2414
5,SONAM BHARTI,Independent,3558,42,3600,0.34,S2414
6,PRADEEP KUMAR,Independent,2547,16,2563,0.24,S2414
7,NOTA,None of the Above,6870,55,6925,0.66,S2414
1,HARENDRA SINGH MALIK,Samajwadi Party,469804,917,470721,43.64,S243
2,SANJEEV KUMAR BALYAN,Bharatiya Janata Party,443815,2234,446049,41.35,S243
3,DARA SINGH PRAJAPATI,Bahujan Samaj Party,143323,384,143707,13.32,S243
4,SUNIL TYAGI,Independent,7131,36,7167,0.66,S243
5,KAVITA,Rashtrawadi Janlok Party (Satya),1970,30,2000,0.19,S243
6,SHASHIKANT SHAMAR,Independent,1429,2,1431,0.13,S243
7,BIRBAL SINGH,Vishal Janta Party,1419,2,1421,0.13,S243
8,NEEL KUMAR,Jai Samta Party,858,3,861,0.08,S243
9,RESHU SHARMA,Independent,679,5,684,0.06,S243
10,ANKUR,Independent,362,10,372,0.03,S243
11,MANUJ VERMA,Independent,333,7,340,0.03,S243
12,NOTA,None of the Above,3884,32,3916,0.36,S243
1,PRADEEP KUMAR SINGH,Bharatiya Janata Party,599118,1028,600146,47.91,S049
2,SHAHNAWAZ,Rashtriya Janata Dal,578904,1148,580052,46.31,S049
3,SHATRUGHAN PRASAD SUMAN,Independent,13697,49,13746,1.1,S049
4,MD GHOUSUL AZAM,Bahujan Samaj Party,12672,18,12690,1.01,S049
5,MD. MOBINUL HAQUE,Independent,12005,3,12008,0.96,S049
6,MD. ISMAIL,Bharatiya Momin Front,7353,1,7354,0.59,S049
7,AKHILESH KUMAR,Independent,5086,34,5120,0.41,S049
8,MUSHTAK ALAM,Independent,4897,2,4899,0.39,S049
9,ZAWED AKHTAR,The National Road Map Party of India,3037,4,3041,0.24,S049
10,NOTA,None of the Above,13438,66,13504,1.08,S049
1,JAI PRAKASH,Bharatiya Janata Party,485745,1053,486798,44.25,S2431
2,USHA VERMA,Samajwadi Party,457553,1389,458942,41.72,S2431
3,BHIMRAO AMBEDKAR,Bahujan Samaj Party,122334,295,122629,11.15,S2431
4,SHIVE KUMAR,Independent,4897,1,4898,0.45,S2431
5,SHYAM  KUMAR,Peoples Party of India (Democratic),4196,4,4200,0.38,S2431
6,SUNIL KUMAR VERMA,Independent,3819,2,3821,0.35,S2431
7,INDRAPAL PASI,Justice Party,2945,1,2946,0.27,S2431
8,MUNNA LAL,Naari Nar Rakshak Party,1588,1,1589,0.14,S2431
9,OM PRAKASH,Independent,1559,2,1561,0.14,S2431
10,AWADESH KUMAR,Independent,1420,4,1424,0.13,S2431
11,PRADEEP KUMAR,Bhartiya Krishak Dal,1349,5,1354,0.12,S2431
12,BRAHMA PRASAD,Lok Jan Sangharsh Party,1139,1,1140,0.1,S2431
13,NOTA,None of the Above,8778,36,8814,0.8,S2431
1,PRANITI SUSHILKUMAR SHINDE,Indian National Congress,618350,1875,620225,51.49,S1342
2,RAM VITTHAL SATPUTE,Bharatiya Janata Party,544770,1258,546028,45.33,S1342
3,AATISH MOHAN BANSODE,Independent,10493,14,10507,0.87,S1342
4,BABLU SIDRAM GAIKWAD,Bahujan Samaj Party,5236,32,5268,0.44,S1342
5,SHRIVIDYADURGADEVI MAULAPPA KURANE,Independent,3489,4,3493,0.29,S1342
6,RAMESH BHIMRAO SHIKHARE,Independent,3146,0,3146,0.26,S1342
7,PROF DR ARJUN GENA OHOL,Bahujan Mukti Party,2651,3,2654,0.22,S1342
8,BHANTENAAGAMURTI MOULAPPA KURANE,Independent,1547,7,1554,0.13,S1342
9,SUNILKUMAR TUKARAM SHINDE,Independent,1478,2,1480,0.12,S1342
10,YUGANDHAR CHANDRAKANT THOKALE,Peoples Party of India (Democratic),1125,0,1125,0.09,S1342
11,PARMESHWAR PANDURANG GEJAGE,Independent,885,1,886,0.07,S1342
12,ADV VIKRAM UTTAM KASABE,Independent,843,3,846,0.07,S1342
13,UGHADE VIJAYKUMAR BHAGWAN,Independent,832,1,833,0.07,S1342
14,KUMAR CHANDRAKANT LONDHE,Baliraja Party,678,1,679,0.06,S1342
15,KRISHNA NAGNATH BHISE,Independent,561,1,562,0.05,S1342
16,ANNA SUKHADEV MASKE,Independent,496,5,501,0.04,S1342
17,MAHASIDDHA TUKARAM GAYAKWAD,Independent,406,3,409,0.03,S1342
18,SUDARSHAN RAYCHAND KHANDARE,Independent,400,1,401,0.03,S1342
19,SONAVANE SHIVAJI CHANDRAKANT,Independent,394,0,394,0.03,S1342
20,SACHIN SHAHU MASKE,Independent,389,0,389,0.03,S1342
21,PROF. DR. SUBHASH KHANDERAO GAIKWAD,Independent,379,1,380,0.03,S1342
22,NOTA,None of the Above,2713,12,2725,0.23,S1342
1,M.K. VISHNUPRASAD,Indian National Congress,450401,4652,455053,44.11,S2226
2,P. SIVAKOZHUNDU,Desiya Murpokku Dravida Kazhagam,267707,1450,269157,26.09,S2226
3,THANKAR BACHAN,Pattali Makkal Katchi,202372,2872,205244,19.9,S2226
4,V. MANIVASAGAN,Naam Tamilar Katchi,56863,561,57424,5.57,S2226
5,S. ARIVUDAINAMBI,Anti Corruption Dynamic Party,6479,21,6500,0.63,S2226
6,A. BALAJI,Independent,5440,10,5450,0.53,S2226
7,V.THANIGAISELVAN,Bahujan Samaj Party,3917,54,3971,0.38,S2226
8,K. MAYAKRISHNAN,Veerath Thiyagi Viswanathadoss Thozhilalarkal Katchi,3696,6,3702,0.36,S2226
9,SU.VA. DHATSHANAMOORTHY,Independent,3414,5,3419,0.33,S2226
10,S. RAMALINGAM,Independent,3208,8,3216,0.31,S2226
11,G. PICHAMUTHU,Independent,2186,8,2194,0.21,S2226
12,R. ANANDHI,Independent,1677,19,1696,0.16,S2226
13,S. CHAKKARAVARTHY,Independent,1484,4,1488,0.14,S2226
14,R. SRINIVASAN,Independent,1352,11,1363,0.13,S2226
15,V. DAKSHANAAMURTHY,Independent,1276,10,1286,0.12,S2226
16,THANGA MURUGAN,Desiya Makkal Sakthi Katchi,1030,6,1036,0.1,S2226
17,R. RAJASEKAR,Independent,701,11,712,0.07,S2226
18,R. PRAKASH,Independent,694,6,700,0.07,S2226
19,S. RAJAMOHAN,Independent,659,1,660,0.06,S2226
20,NOTA,None of the Above,7084,208,7292,0.71,S2226
1,CHAVAN VASANTRAO BALWANTRAO,Indian National Congress,526865,2029,528894,46.88,S1316
2,CHIKHALIKAR PRATAPRAO GOVINDRAO,Bharatiya Janata Party,467452,2000,469452,41.61,S1316
3,AVINASH VISHWANATH BHOSIKAR,Vanchit Bahujan  Aaghadi,92090,422,92512,8.2,S1316
4,PANDURANG RAMA ADGULWAR,Bahujan Samaj Party,6879,22,6901,0.61,S1316
5,NIKHIL LAXMANRAO GARJE,Independent,4320,5,4325,0.38,S1316
6,NAGESH SAMBHAJI GAIKWAD,Independent,3316,2,3318,0.29,S1316
7,BHASKAR CHAMPATRAO DOIFODE,Independent,2078,2,2080,0.18,S1316
8,SUSHILA NILKANTHRAO PAWAR,Samnak Janta Party,1873,17,1890,0.17,S1316
9,ABDUL RAIS AHEMAD,Desh Janhit Party,1508,2,1510,0.13,S1316
10,DEVIDAS GOVINDRAO INGLE,Independent,1466,5,1471,0.13,S1316
11,KALPANA SANJAY GAIKWAD,Independent,1305,5,1310,0.12,S1316
12,KAUSAR SULTANA,Indian National League,1211,4,1215,0.11,S1316
13,SAHEBRAO BHIVA GAJBHARE,Independent,1189,4,1193,0.11,S1316
14,JAGDISH LAXMAN POTRE,Independent,960,3,963,0.09,S1316
15,GAJANAN DATTRAMJI DHUMAL,Independent,948,2,950,0.08,S1316
16,LAXMAN NAGORAO PATIL,Independent,921,2,923,0.08,S1316
17,MAHARUDRA KESHAV POPLAITKAR,Independent,911,2,913,0.08,S1316
18,RUKMINBAI SHANKARRAO GITE,Bharatiya Praja Surajya Paksha,897,6,903,0.08,S1316
19,HARI PIRAJI BOYALE,Bahujan Bharat Party,877,1,878,0.08,S1316
20,RATHOD SURESH GOPINATH,Independent,806,2,808,0.07,S1316
21,KADAM SURAJ DEVENDRA,Independent,796,3,799,0.07,S1316
22,RAHUL SURYAKANT YANGADE,Bahujan Mukti Party,734,3,737,0.07,S1316
23,DNYANESHWAR RAOSAHEB KAPATE,Independent,679,2,681,0.06,S1316
24,NOTA,None of the Above,3579,49,3628,0.32,S1316
1,UJJWAL RAMAN SINGH,Indian National Congress,461100,1045,462145,48.8,S2452
2,NEERAJ TRIPATHI,Bharatiya Janata Party,402659,691,403350,42.59,S2452
3,RAMESH KUMAR PATEL,Bahujan Samaj Party,49045,99,49144,5.19,S2452
4,GOPAL SWROOP JOSHI,Independent,4248,0,4248,0.45,S2452
5,AJEET KUMAR PATEL,Pragatisheel Samaj Party,2641,1,2642,0.28,S2452
6,MOOLNIWASI HEMRAJ SINGH,Peoples Party of India (Democratic),2350,5,2355,0.25,S2452
7,GEETA RANI SHARMA,Independent,2197,0,2197,0.23,S2452
8,HANSHRAJ KOL,Apna Dal (Kamerawadi),2137,4,2141,0.23,S2452
9,RAJENDRA PRASAD PRAJAPATI,Bhagidari Party(P),1844,3,1847,0.2,S2452
10,AVANEESH KUMAR,Independent,1834,1,1835,0.19,S2452
11,ANUJ SWAROOP SHUKLA,Independent,1615,1,1616,0.17,S2452
12,SHIV PRASAD VISHWAKARMA,Samyak Party,1326,0,1326,0.14,S2452
13,SARVAJEET SINGH,Kamera Samaj Party,1177,0,1177,0.12,S2452
14,RAJDHAR SINGH PATEL,Rashtriya Samaj Dal (R),1024,1,1025,0.11,S2452
15,NOTA,None of the Above,9949,3,9952,1.05,S2452
1,JUAL ORAM,Bharatiya Janata Party,490655,3627,494282,42.77,S182
2,DILIP KUMAR TIRKEY,Biju Janata Dal,353708,1766,355474,30.76,S182
3,JANARDAN DEHURY,Indian National Congress,260681,1305,261986,22.67,S182
4,JUSTIN LUGUN,Socialist Unity Centre Of India (COMMUNIST),9120,21,9141,0.79,S182
5,JAGABANDHU ORAM,Independent,6023,4,6027,0.52,S182
6,SUMANTA KUMAR SORENG,National Apni Party,4035,17,4052,0.35,S182
7,SANTOSH JURA,Naba Bharata Nirmana Seva Party,3976,5,3981,0.34,S182
8,PARUA EKKA,Jharkhand Party,3018,15,3033,0.26,S182
9,NOTA,None of the Above,17752,49,17801,1.54,S182
1,GIRIDHARI YADAV,Janata Dal  (United),505674,1004,506678,49.96,S0427
2,JAI PRAKASH NARAYAN YADAV,Rashtriya Janata Dal,401567,1267,402834,39.72,S0427
3,NARESH YADAV,Independent,14936,3,14939,1.47,S0427
4,JAY PRAKASH YADAV,Rashtriya Jansambhavna Party,12254,23,12277,1.21,S0427
5,AMRIT TANTI,Bhartiya Dalit Party,9615,55,9670,0.95,S0427
6,NARESH KUMAR PRIYADARSHI,Independent,8103,22,8125,0.8,S0427
7,GANESH KUMAR KUSHAWAHA,Samata Party,7627,18,7645,0.75,S0427
8,UTTAM KUMAR SINGH,Aam Janta Party Rashtriya,6874,37,6911,0.68,S0427
9,KAVINDRA PANDIT,Socialist Unity Centre Of India (COMMUNIST),5226,20,5246,0.52,S0427
10,UMAKANT YADAV,Independent,4932,9,4941,0.49,S0427
11,NOTA,None of the Above,34808,81,34889,3.44,S0427
1,SHOBHANABEN MAHENDRASINH BARAIYA,Bharatiya Janata Party,670929,6389,677318,53.36,S065
2,CHAUDHARI TUSHAR AMARSINH,Indian National Congress,515902,5734,521636,41.09,S065
3,PARMAR RAMESHCHANDRA NANJIBHAI,Bahujan Samaj Party,9850,117,9967,0.79,S065
4,SOLANKI CHHAGANBHAI KEVLABHAI,Independent,7539,12,7551,0.59,S065
5,VIJAYSINH NAVALSINH CHAUHAN,Independent,6692,29,6721,0.53,S065
6,BHAVNABA NARENDRASINH PARMAR,Independent,5365,94,5459,0.43,S065
7,ANILKUMAR NIRANJANKUMAR MUNDADA,Log Party,5225,22,5247,0.41,S065
8,MUSTAKBHAI JAMALBHAI SANGHANI,Independent,3196,7,3203,0.25,S065
9,KATARA VARUNKUMAR KALYANSINH,Gunj Satya Ni Janata Party,2717,56,2773,0.22,S065
10,RAKESHSINH MAHOBATSINH ZALA,Bhartiya Jan Parishad,1882,69,1951,0.15,S065
11,PANDOR KAUSHIKKUMAR SHANKARBHAI,Independent,1782,45,1827,0.14,S065
12,ASHOK L VAGHELA,Independent,1673,15,1688,0.13,S065
13,KANUBHAI KHIMJIBHAI GADHAVI,Independent,1467,38,1505,0.12,S065
14,THAKOR INDIRABEN JITENDRASINH,Insaniyat Party,1402,34,1436,0.11,S065
15,NOTA,None of the Above,20665,411,21076,1.66,S065
1,HEMAMALINI DHARMENDRA DEOL,Bharatiya Janata Party,507535,2529,510064,53.3,S2417
2,MUKESH DHANGAR,Indian National Congress,216043,614,216657,22.64,S2417
3,SURESH SINGH,Bahujan Samaj Party,188152,265,188417,19.69,S2417
4,BHANU PRATAP SINGH,Independent,15640,25,15665,1.64,S2417
5,RAKESH KUMAR,Independent,4492,2,4494,0.47,S2417
6,JAGDISH PRASAD KAUSHIK ADVOCATE,Rashtriya Samta Vikas Party,3567,8,3575,0.37,S2417
7,RAVI VERMA,Independent,2724,0,2724,0.28,S2417
8,SHIKHA SHARMA,Independent,2246,5,2251,0.24,S2417
9,KAMAL KANT SHARMA,Independent,1491,12,1503,0.16,S2417
10,YOGESH KUMAR TALAN,Independent,1491,2,1493,0.16,S2417
11,MONI FALHARI BAPU,Independent,1322,4,1326,0.14,S2417
12,KSHETRA PAL SINGH,Independent,1206,5,1211,0.13,S2417
13,DR. RASHMI YADAV,Independent,1183,6,1189,0.12,S2417
14,PRAVESHANAND PURI,Independent,1081,4,1085,0.11,S2417
15,SURESH CHANDRA VAGHEL,Rashtriya Shoshit Samaj Party,822,7,829,0.09,S2417
16,NOTA,None of the Above,4527,36,4563,0.48,S2417
1,DR BYREDDY SHABARI,Telugu Desam,689417,11714,701131,49.92,S0117
2,POCHA BRAHMANANDA REDDY,Yuvajana Sramika Rythu Congress Party,583155,6001,589156,41.95,S0117
3,J LAKSHMI NARASIMHA YADAV,Indian National Congress,54920,1284,56204,4,S0117
4,P GURUVAIAH,Independent,8190,1,8191,0.58,S0117
5,A CHINNA MOULALI,Bahujan Samaj Party,7768,63,7831,0.56,S0117
6,HAFIZ ATAULLAH KHAN,Social Democratic Party Of India,6858,74,6932,0.49,S0117
7,KOMMUSANI PEDDA KAMBAGIRI SWAMY,Independent,4633,0,4633,0.33,S0117
8,GAGGERA VENKATA RAMANAIAH,Independent,3027,4,3031,0.22,S0117
9,DUMAVATH SWAMY NAIK,Independent,2348,10,2358,0.17,S0117
10,KUNUKUNTLA RAMUDU,Independent,1408,5,1413,0.1,S0117
11,E ANIL KUMAR,Independent,1332,2,1334,0.09,S0117
12,C SURENDRA NATHA REDDY,Independent,1267,1,1268,0.09,S0117
13,BRAHMANANDA REDDY K,Independent,1261,11,1272,0.09,S0117
14,UPPU SUBBARAYUDU,Jaathia Chethi Vruthula Ikya Vedika Party,785,6,791,0.06,S0117
15,NAGESWARA RAO,Independent,678,2,680,0.05,S0117
16,VIJAYA BHASKAR REDDYPOGU,Independent,641,0,641,0.05,S0117
17,YELAMPALLE GOVARDHAN REDDY,All India Forward Bloc,638,4,642,0.05,S0117
18,BHUMA VEERA BHADRA REDDY,Navarang Congress Party,630,16,646,0.05,S0117
19,PANDU RANGA YADAV SIDDAPU,Samajwadi Party,594,11,605,0.04,S0117
20,CHANDINI REDDY VAKATI,Liberation Congress Party,546,10,556,0.04,S0117
21,B C RAMANADHA AREDDY,Independent,472,0,472,0.03,S0117
22,GAJULA SHALIMIYA,Anna YSR Congress Party,468,18,486,0.03,S0117
23,KULURU RAMA KRISHNA REDDY,Neethi Nijayithi Party,428,2,430,0.03,S0117
24,CH P MALLESWARUDU,Independent,417,4,421,0.03,S0117
25,I V PAKKIR REDDY,Independent,408,2,410,0.03,S0117
26,V MADHUSUDHANA REDDY,Independent,399,2,401,0.03,S0117
27,BUSHAKU MAHESWARA REDDY,Independent,390,0,390,0.03,S0117
28,U P MUNI REDDY,Independent,376,0,376,0.03,S0117
29,GOGULA SUGUNAMMA,Jai Maha Bharath Party,375,4,379,0.03,S0117
30,BELLAMKONDA SREENIVASULU,Independent,352,1,353,0.03,S0117
31,BALIJA SHIVA KUMAR,Independent,288,0,288,0.02,S0117
32,NOTA,None of the Above,10538,159,10697,0.76,S0117
1,GAJENDRA SINGH PATEL,Bharatiya Janata Party,818291,1572,819863,52.6,S1227
2,PORLAL BATHA KHARTE,Indian National Congress,683651,1194,684845,43.93,S1227
3,DEVISINGH NARGAVE,Communist Party of India,14680,6,14686,0.94,S1227
4,SHOBHARAM DAWAR,Bahujan Samaj Party,12047,22,12069,0.77,S1227
5,NARSINGH SOLANKI,Independent,9052,6,9058,0.58,S1227
6,NOTA,None of the Above,18237,20,18257,1.17,S1227
1,SELVARAJ V,Communist Party of India,462759,2285,465044,47.79,S2229
2,DR SURSITH SANKAR G,All India Anna Dravida Munnetra Kazhagam,254676,1411,256087,26.32,S2229
3,KARTHIKA M,Naam Tamilar Katchi,130846,448,131294,13.49,S2229
4,RAMESHGOVIND S G M,Bharatiya Janata Party,101535,638,102173,10.5,S2229
5,VIJAYARAGAVAN N,Independent,3072,30,3102,0.32,S2229
6,SUBRAMANIAN K,Independent,2434,33,2467,0.25,S2229
7,JAGADEESH J BE,Bahujan Samaj Party,1789,17,1806,0.19,S2229
8,BOOMINATHAN B,Desiya Makkal Sakthi Katchi,1048,2,1050,0.11,S2229
9,PREM S,Independent,1047,23,1070,0.11,S2229
10,NOTA,None of the Above,8843,75,8918,0.92,S2229
1,SAGAR ESHWAR KHANDRE,Indian National Congress,665162,1155,666317,53.63,S107
2,BHAGWANTH KHUBA,Bharatiya Janata Party,535766,1676,537442,43.26,S107
3,AMBADAS SOPANRAO HULSURE,Bahujan Bharat Party,5300,2,5302,0.43,S107
4,PUTARAJ,Bahujan Samaj Party,4541,13,4554,0.37,S107
5,DR. DINKAR MORE,Independent,4105,11,4116,0.33,S107
6,SRI ROPH ABDUL GANI,Independent,3101,3,3104,0.25,S107
7,SHIVRAJ ADIVEPPA SATWAR,Independent,3076,3,3079,0.25,S107
8,RAMVILAS RAMULALJI NAVANDAR,Independent,2694,0,2694,0.22,S107
9,RIYAZ AHMED,Independent,1710,1,1711,0.14,S107
10,MOHD. SHAFEEQ UR RAHAMAN,All India Ulama Congress,1684,10,1694,0.14,S107
11,JAIRAJ KASHAPPA BUKKA ADVOCATE,Independent,1493,0,1493,0.12,S107
12,BALBHEEM UNNE,Independent,1462,8,1470,0.12,S107
13,WASEEMUDDIN,Independent,1169,1,1170,0.09,S107
14,MAHESH GORNALKAR,Republican Party of India (A),974,7,981,0.08,S107
15,DILIP KADWAD,Independent,791,7,798,0.06,S107
16,GOPAL M.P. GARAMPALLI,Independent,765,2,767,0.06,S107
17,RAMESH J CHAVAN,Karnataka Rashtra Samithi,471,1,472,0.04,S107
18,RAMCHANDRA NARAYAN KACHAVE,Kranti Kari Jai Hind Sena,468,4,472,0.04,S107
19,NOTA,None of the Above,4674,12,4686,0.38,S107
1,NITIN JAIRAM GADKARI,Bharatiya Janata Party,652809,2218,655027,54.08,S1310
2,VIKAS THAKRE,Indian National Congress,515941,1483,517424,42.72,S1310
3,YOGIRAJ ALIAS YOGESH PATIRAM LANJEWAR,Bahujan Samaj Party,19164,78,19242,1.59,S1310
4,KIVINSUKA VIRENDRA SURYAVANSHI,Desh Janhit Party,2055,4,2059,0.17,S1310
5,ADARSH RAVISHANKAR THAKUR,Independent,1749,1,1750,0.14,S1310
6,ADV ULHAS SHALIKRAM DUPARE,Independent,1346,2,1348,0.11,S1310
7,FAHIM SHAMIM KHAN,Minorities Democratic Party,1072,1,1073,0.09,S1310
8,SURAJ BALRAM MISHRA,Kunbi Bahujan Sawrajya Party,814,3,817,0.07,S1310
9,TEKRAJ BELKHODE,Independent,803,5,808,0.07,S1310
10,GARUDADRI ANAND KUMAR,Akhil Bhartiya Parivar Party,719,1,720,0.06,S1310
11,DHANU WALTHARE,Independent,690,2,692,0.06,S1310
12,VIJAY MANKAR,Ambedkarite Party of India,606,4,610,0.05,S1310
13,ADV. SANTOSH RAMKRISHNA LANJEWAR,All India Forward Bloc,565,2,567,0.05,S1310
14,VISHESH VASANTA FUTANE,Bahujan Republican  Socialist Party,559,3,562,0.05,S1310
15,GUNWANT HARICHANDRA SOMKUWAR,Bharatheeya Jawan Kisan Party,465,6,471,0.04,S1310
16,SHRIDHAR NARAYAN SALVE,Bhim Sena,447,4,451,0.04,S1310
17,SUNIL WANKHEDE,Rashtra Samarpan Party,320,2,322,0.03,S1310
18,DIPAK LAXMANRAO MASKE,Bahujan Maha Party,267,3,270,0.02,S1310
19,NARAYAN TUKARAM CHOUDHARI,Socialist Unity Centre Of India (COMMUNIST),251,0,251,0.02,S1310
20,SANTOSH TULSHIRAM CHAVHAN,Independent,242,0,242,0.02,S1310
21,SUSHIL PATIL,Independent,236,1,237,0.02,S1310
22,SACHIN RAMKRUSHNARAO WAGHADE,Independent,202,0,202,0.02,S1310
23,PRAFUL MANIKCHAND BHANGE,Independent,201,0,201,0.02,S1310
24,VINAYAK BHAURAO AWCHAT,Independent,190,0,190,0.02,S1310
25,BABITA RAJU AWASTHI,Independent,179,3,182,0.02,S1310
26,SAHIL BALCHAND TURKAR,Independent,129,0,129,0.01,S1310
27,NOTA,None of the Above,5434,40,5474,0.45,S1310
1,ADV K FRANCIS GEORGE,Kerala Congress,358369,6262,364631,43.6,S1114
2,THOMAS CHAZHIKADAN,Kerala Congress  (M),272418,4947,277365,33.17,S1114
3,THUSHAR VELLAPPALLY,Bharath Dharma Jana Sena,163227,1819,165046,19.74,S1114
4,VIJU CHERIAN,Bahujan Samaj Party,7075,148,7223,0.86,S1114
5,P O PETER,Samajwadi Jan Parishad,1581,56,1637,0.2,S1114
6,V P KOCHUMON,Socialist Unity Centre Of India (COMMUNIST),1551,44,1595,0.19,S1114
7,JOSSIN K JOSEPH,Independent,1397,92,1489,0.18,S1114
8,CHANDRABOSE P,Independent,1071,16,1087,0.13,S1114
9,M M SCARIA,Independent,913,14,927,0.11,S1114
10,JOEMON JOSEPH SRAMPICKAL A P J JUMAN V S,Independent,875,18,893,0.11,S1114
11,ROBY MATTAPPALLY,Independent,697,42,739,0.09,S1114
12,SANTHOSH PULICKAL,Independent,686,24,710,0.08,S1114
13,SUNIL ALANCHERIL,Independent,499,28,527,0.06,S1114
14,MAN HOUSE MANMADHAN,Independent,403,18,421,0.05,S1114
15,NOTA,None of the Above,11804,129,11933,1.43,S1114
1,SHREYAS. M. PATEL,Indian National Congress,670274,2714,672988,49.67,S1016
2,PRAJWAL REVANNA,Janata Dal  (Secular),626536,3803,630339,46.52,S1016
3,GANGADHAR BAHUJAN,Bahujan Samaj Party,12068,105,12173,0.9,S1016
4,DEVARAJ M.Y,Karnataka Rashtra Samithi,6033,24,6057,0.45,S1016
5,H D REVANNA,Purvanchal Mahapanchayat,4256,16,4272,0.32,S1016
6,BASAVARAJU J.D (EX-ARMY),Independent,3983,80,4063,0.3,S1016
7,SANTHOSH B.N,Independent,3444,5,3449,0.25,S1016
8,HEMANTH GAVEESH,Independent,3277,4,3281,0.24,S1016
9,PRATHAPA K.A,Uttama Prajaakeeya Party,3213,37,3250,0.24,S1016
10,S.K. NINGARAJA,Bahujan Bharat Party,1710,20,1730,0.13,S1016
11,B.N. SURESHA (SURESHGOWDA),Independent,1409,9,1418,0.1,S1016
12,SIDDABHOVI,Independent,940,47,987,0.07,S1016
13,SHIVARAJ. B,Republican Party of India Bharatha,843,5,848,0.06,S1016
14,R.G. SATHISHA RAMEDEVARAPURA,Independent,823,46,869,0.06,S1016
15,K.R. GANGADHARAPPA,Independent,734,8,742,0.05,S1016
16,NOTA,None of the Above,8470,71,8541,0.63,S1016
1,PIYUSH GOYAL,Bharatiya Janata Party,678451,1695,680146,65.68,S1326
2,BHUSHAN PATIL,Indian National Congress,321455,1083,322538,31.15,S1326
3,ADV. SONAL DIWAKAR GONDANE,Vanchit Bahujan  Aaghadi,6007,45,6052,0.58,S1326
4,RAIS DOCTOR,Bahujan Samaj Party,2907,16,2923,0.28,S1326
5,PANDEY DHARMENDRA RAMMURAT,Independent,1481,0,1481,0.14,S1326
6,DIPTI ASHOK WALAWALKAR,Independent,1461,11,1472,0.14,S1326
7,COMRADE JAYRAM VISHWAKARMA,Socialist Unity Centre Of India (COMMUNIST),1194,1,1195,0.12,S1326
8,MUNNALAL GAJRAJ PRAJAPATI,Independent,968,3,971,0.09,S1326
9,LAXMAN YELLPPA KURADE,Independent,680,6,686,0.07,S1326
10,ADVOCATE KAPIL K. SONI,Independent,630,3,633,0.06,S1326
11,DEEPALI BHAWARSING SHEKHAWAT,Maharashtra Vikas Aghadi,621,4,625,0.06,S1326
12,KAMLESH DAYABHAI VYAS,Sardar Vallabhbhai Patel Party,619,3,622,0.06,S1326
13,BIPIN BACHUBHAI SHAH,Hindu Samaj Party,505,3,508,0.05,S1326
14,GURUDAS RAMDAS KHAIRNAR,Independent,484,2,486,0.05,S1326
15,RAVI BABU GAVLI,Samata Party,447,3,450,0.04,S1326
16,JAEENDRA VASANT SURVE,Bharatheeya Jawan Kisan Party,398,7,405,0.04,S1326
17,ALIEK SUNDER MESHRAM,Bharatiya Mulnivasi Aazad Party,393,3,396,0.04,S1326
18,SAYED ZULFIQAR ALAM,Bahujan Maha Party,344,4,348,0.03,S1326
19,SANJAY MAFATLAL MORAKHIA,Independent,210,0,210,0.02,S1326
20,NOTA,None of the Above,13248,98,13346,1.29,S1326
1,SARBANANDA SONOWAL,Bharatiya Janata Party,691153,2609,693762,54.27,S0313
2,LURINJYOTI GOGOI,Assam Jatiya Parishad,412793,1648,414441,32.42,S0313
3,MANOJ DHANOWAR,Aam Aadmi Party,137618,246,137864,10.78,S0313
4,NOTA,None of the Above,32163,92,32255,2.52,S0313
1,RUCHI VIRA,Samajwadi Party,636733,630,637363,49.67,S246
2,KUNWAR SARVESH KUMAR,Bharatiya Janata Party,530176,1425,531601,41.43,S246
3,MO IRFAN,Bahujan Samaj Party,92116,197,92313,7.19,S246
4,AJAY YADAV,Apna Haq Party,4084,10,4094,0.32,S246
5,MUSHARRAT HUSAIN,Independent,2583,0,2583,0.2,S246
6,SADHNA SINGH,Independent,2292,4,2296,0.18,S246
7,MOHD JAMSHED,Independent,1717,2,1719,0.13,S246
8,ONKAR SINGH,Bharatiya Bahujan Samta Party,1449,10,1459,0.11,S246
9,SHAKIL AHMED,Samata Party,1356,0,1356,0.11,S246
10,HAR KISHORE SINGH,Socialist Unity Centre Of India (COMMUNIST),940,0,940,0.07,S246
11,AMARJEET SINGH JATAV,Independent,937,15,952,0.07,S246
12,GANGARAM SHARMA,Rashtriya Congress(J) Party,629,56,685,0.05,S246
13,NOTA,None of the Above,5807,17,5824,0.45,S246
1,AMOL GAJANAN KIRTIKAR,Shiv Sena (Uddhav Balasaheb Thackrey),451095,1501,452596,47.4,S1327
2,RAVINDRA DATTARAM WAIKAR,Shiv Sena,451094,1550,452644,47.4,S1327
3,PARMESHWAR ASHOK RANSHUR,Vanchit Bahujan  Aaghadi,10001,51,10052,1.05,S1327
4,RAJESH RAMKISAN MALLAH,Bahujan Samaj Party,4790,22,4812,0.5,S1327
5,SAMEER MORE,Independent,3171,2,3173,0.33,S1327
6,SUNIL BHIMA CHAVAN,Independent,1999,3,2002,0.21,S1327
7,BALA VENKATESH VINAYAK NADAR,Aapki Apni Party (Peoples),1756,7,1763,0.18,S1327
8,ARORA SURINDER MOHAN,Bharat Jan Aadhar Party,1667,8,1675,0.18,S1327
9,ROHAN SATONE,Independent,1476,3,1479,0.15,S1327
10,ADV. SANJEEVKUMAR APPARAV KALKORI,Independent,1184,13,1197,0.13,S1327
11,ADV. LATA PANDURANG SHINDE,Independent,1152,2,1154,0.12,S1327
12,MANOJ SHRAVAN NAYAK,Right to Recall Party,1132,17,1149,0.12,S1327
13,HRUDA DHANANJAY SHINDE,Independent,1066,12,1078,0.11,S1327
14,BHARAT KHIMJI SHAH,Hindu Samaj Party,932,5,937,0.1,S1327
15,SUSHMA DAYANAND MEHTA,Independent,875,7,882,0.09,S1327
16,ADVOCATE KAPIL KANTILAL SONI,Independent,776,4,780,0.08,S1327
17,SARIKA DABRAL,India Greens Party,760,8,768,0.08,S1327
18,GAJANAN TUKARAM SONKAMBLE,Independent,496,5,501,0.05,S1327
19,ADV MITESH VARSHNEY,Bhim Sena,492,5,497,0.05,S1327
20,HARISHANKAR YADAV,Samaj Vikas Kranti Party,398,7,405,0.04,S1327
21,SANTOSH MANIK RAYBAN,Independent,234,0,234,0.02,S1327
22,NOTA,None of the Above,15036,125,15161,1.59,S1327
1,MALVIKA DEVI,Bharatiya Janata Party,538535,5768,544303,40.79,S1811
2,LAMBODAR NIAL,Biju Janata Dal,408267,2223,410490,30.77,S1811
3,DROUPADI MAJHI,Indian National Congress,300060,3139,303199,22.72,S1811
4,UMAKANTA TANDI,Independent,9180,14,9194,0.69,S1811
5,BIRANCHI NARAYAN DURGA,Bahujan Samaj Party,8440,57,8497,0.64,S1811
6,DR. DHARMANANDA GAHIR,Independent,7775,36,7811,0.59,S1811
7,SIBA HATI,Samajwadi Party,7138,30,7168,0.54,S1811
8,RAJARAM SAHU,Independent,6712,18,6730,0.5,S1811
9,NARESH HIANLA,Independent,6627,14,6641,0.5,S1811
10,GANGADHAR JAL,Independent,5547,43,5590,0.42,S1811
11,HIMANSHU TRIPATHY,Samruddha Odisha,4898,8,4906,0.37,S1811
12,NOTA,None of the Above,19620,95,19715,1.48,S1811
1,KRISHNA PRASAD TENNETI,Telugu Desam,706757,10736,717493,55.16,S0115
2,NANDIGAM SURESH BABU,Yuvajana Sramika Rythu Congress Party,503816,5646,509462,39.17,S0115
3,J.D. SEELAM,Indian National Congress,41673,1586,43259,3.33,S0115
4,DOKKA JAGAN MOHANA RAO,Bahujan Samaj Party,6774,83,6857,0.53,S0115
5,NALAMALA TIRUPATI RAO,Navataram Party,2888,76,2964,0.23,S0115
6,BUSSA. NAGARAJU,Independent,1311,7,1318,0.1,S0115
7,GADDE. VIJAYA LAKSHMI,Independent,1046,5,1051,0.08,S0115
8,KATTAPOGU. VIJAY KUMAR,Pyramid Party of India,893,4,897,0.07,S0115
9,KONDRU KIRAN KUMAR,Independent,791,6,797,0.06,S0115
10,KATTA ANAND BABU,Independent,704,25,729,0.06,S0115
11,MERUGUPALA SADASIVA RAO,India Praja Bandhu Party,669,4,673,0.05,S0115
12,KATTA HEMANAND,Independent,547,2,549,0.04,S0115
13,PARRE. KOTAIAH,Jaibhim Rao Bharat Party,408,4,412,0.03,S0115
14,PALADUG VIJENDRA RAO (BAHUJAN),Liberation Congress Party,294,12,306,0.02,S0115
15,CHINNAM MURALIDHAR,All Peoples Party,252,3,255,0.02,S0115
16,NOTA,None of the Above,13599,124,13723,1.06,S0115
1,HIBI EDEN,Indian National Congress,478989,3328,482317,52.97,S1112
2,K. J. SHINE TEACHER,Communist Party of India  (Marxist),230059,1873,231932,25.47,S1112
3,DR. K. S. RADHAKRISHNAN,Bharatiya Janata Party,143573,927,144500,15.87,S1112
4,ADV. ANTONY JUDY,Twenty 20 Party,39658,150,39808,4.37,S1112
5,VAYALAR JAYAKUMAR,Bahujan Samaj Party,1480,18,1498,0.16,S1112
6,SANDEEP RAJENDRAPRASAD,Independent,734,18,752,0.08,S1112
7,CYRILL SKARIA,Independent,663,27,690,0.08,S1112
8,PRATHAPAN,Bahujan Dravida Party,414,5,419,0.05,S1112
9,BRAHMAKUMAR,Socialist Unity Centre Of India (COMMUNIST),409,3,412,0.05,S1112
10,ROHIT KRISHNAN,Independent,408,8,416,0.05,S1112
11,NOTA,None of the Above,7715,43,7758,0.85,S1112
1,OM BIRLA,Bharatiya Janata Party,744396,6100,750496,50.03,S2024
2,PRAHLAD GUNJAL,Indian National Congress,702623,5899,708522,47.23,S2024
3,DHANRAJ YADAV,Bahujan Samaj Party,7547,28,7575,0.5,S2024
4,ASHISH YOGI,Ekam Sanatan Bharat Dal,5756,19,5775,0.38,S2024
5,LAKSHMICHAND,Independent,3890,2,3892,0.26,S2024
6,SATYENDRA KUMAR JAIN,Independent,2520,1,2521,0.17,S2024
7,RAMNATH MEHRA,Independent,2407,15,2422,0.16,S2024
8,MOINUDDIN,Independent,1854,6,1860,0.12,S2024
9,BHANWAR KUMAR RAWAL,Independent,1102,29,1131,0.08,S2024
10,BALDEV SINGH FOJI,Bharatheeya Jawan Kisan Party,1066,3,1069,0.07,S2024
11,TARUN GOCHAR,Right to Recall Party,992,8,1000,0.07,S2024
12,KAILASHI ANIL JAIN,Independent,990,4,994,0.07,S2024
13,KAMAL KUMAR BAIRWA,Independent,965,49,1014,0.07,S2024
14,ABDUL ASIF,Independent,860,5,865,0.06,S2024
15,OM PRAKASH SHAKYAWAL,Independent,757,3,760,0.05,S2024
16,NOTA,None of the Above,10176,85,10261,0.68,S2024
1,RAM SHIROMANI VERMA,Samajwadi Party,510754,301,511055,48.83,S2458
2,SAKET MISRA,Bharatiya Janata Party,434192,190,434382,41.51,S2458
3,MUINUDDIN AHAMAD KHAN URF HAZI DADDAN KHAN,Bahujan Samaj Party,56225,26,56251,5.38,S2458
4,AHMAD JIYA KHAN,Peace Party,15630,0,15630,1.49,S2458
5,SHANTI DEVI,Independent,4010,1,4011,0.38,S2458
6,SUJEET KUMAR,Independent,3946,0,3946,0.38,S2458
7,YUGAL KISHOR SHUKLA,Aam Janta Party (India),2672,1,2673,0.26,S2458
8,KRISHNA KUMAR MAURYA,Samyak Party,2266,1,2267,0.22,S2458
9,MALIK RAM,Independent,2111,2,2113,0.2,S2458
10,ANIL KUMAR TIWARI,Independent,1513,1,1514,0.14,S2458
11,HANUMAN PRASAD MISHRA,Kisan Mazdoor Sangharsh Party,1494,1,1495,0.14,S2458
12,KUMARI GEETA GAUTAM,Rashtriya Janta Party,1317,2,1319,0.13,S2458
13,NOTA,None of the Above,9872,0,9872,0.94,S2458
1,AKHILESH YADAV,Samajwadi Party,640207,2085,642292,52.74,S2442
2,SUBRAT PATHAK,Bharatiya Janata Party,470131,1239,471370,38.71,S2442
3,IMRAN BIN ZAFAR,Bahujan Samaj Party,81471,168,81639,6.7,S2442
4,ALOK VERMA,Rashtriya Shoshit Samaj Party,4484,8,4492,0.37,S2442
5,LALIT KUMARI,Independent,3262,5,3267,0.27,S2442
6,SINOD KUMAR,Independent,1732,1,1733,0.14,S2442
7,RAJ KATHERIA,Independent,1463,1,1464,0.12,S2442
8,BHANU PRATAP SINGH DOHRE,Independent,1430,2,1432,0.12,S2442
9,SHAILENDRA KUMAR,Bharatiya Kisan Parivartan Party,1141,10,1151,0.09,S2442
10,YADVENDRA KISHOR,Independent,1061,1,1062,0.09,S2442
11,SUBHASH CHANDRA,All India Forward Bloc,799,2,801,0.07,S2442
12,SUNIL,Bhartiya Shakti Chetna Party,738,1,739,0.06,S2442
13,PRAMOD KUMAR YADAV,Bhartiya Krishak Dal,557,3,560,0.05,S2442
14,PURUSHOTTAM TIWARI,Independent,541,2,543,0.04,S2442
15,IRFAN ALI,Independent,463,7,470,0.04,S2442
16,NOTA,None of the Above,4805,13,4818,0.4,S2442
1,PARTHA BHOWMICK,All India Trinamool Congress,518486,1745,520231,45.56,S2515
2,ARJUN SINGH,Bharatiya Janata Party,454184,1609,455793,39.92,S2515
3,DEBDUT GHOSH,Communist Party of India  (Marxist),109038,526,109564,9.6,S2515
4,MD JAMIR HOSSAIN,All India Secular Front,18797,9,18806,1.65,S2515
5,ROHIT KUMAR PATHAK,Independent,7116,16,7132,0.62,S2515
6,CHAPALA RAY (MAJUMDER),Bahujan Samaj Party,3882,27,3909,0.34,S2515
7,SHARMISTHA DAS,Independent,3622,12,3634,0.32,S2515
8,ANJAN GOSWAMI,Bharatiya Nyay-Adhikar Raksha Party,3434,14,3448,0.3,S2515
9,DHARMENDRA SINGH,Independent,2843,4,2847,0.25,S2515
10,SANJAY SINGH,Independent,1670,6,1676,0.15,S2515
11,DEBASISH BANERJEE,Socialist Unity Centre Of India (COMMUNIST),1422,12,1434,0.13,S2515
12,KUNDAN SINGH,Independent,820,6,826,0.07,S2515
13,UDAY VEER CHOUDHURY,Independent,745,12,757,0.07,S2515
14,AMIT KUMAR CHOUBEY,Independent,717,4,721,0.06,S2515
15,NOTA,None of the Above,11043,39,11082,0.97,S2515
1,RAVI SHANKAR PRASAD,Bharatiya Janata Party,587212,1058,588270,54.7,S0430
2,ANSHUL AVIJIT,Indian National Congress,433818,606,434424,40.39,S0430
3,RAKESH SHARMA,Independent,9942,1,9943,0.92,S0430
4,NEERAJ KUMAR,Bahujan Samaj Party,5912,16,5928,0.55,S0430
5,AWADHESH PRASAD,Independent,4973,1,4974,0.46,S0430
6,ENG UMESH RAJAK,Peoples Party of India (Democratic),4664,8,4672,0.43,S0430
7,SANJAY KUMAR URF SANJAY BALMIKI,Independent,4643,0,4643,0.43,S0430
8,DHARMVIR KUMAR BHASKAR,Independent,2415,1,2416,0.22,S0430
9,AMIT KUMAR ALBELA,Independent,2050,3,2053,0.19,S0430
10,MAHESH KUMAR,Samata Party,2003,0,2003,0.19,S0430
11,DHANJAY KUMAR,Rashtriya Jansambhavna Party,1969,2,1971,0.18,S0430
12,GULAB PRASAD,Loktantrik Samajwadi Party,1923,2,1925,0.18,S0430
13,SUMIT RANJAN SINHA,Akhand Bharat Janpriya Party,1715,1,1716,0.16,S0430
14,MAHBOOB ALAM ANSARI,Bharatiya Momin Front,1635,3,1638,0.15,S0430
15,DR RAKESH DUTTA MISHRA,Bharatiya Jan Kranti Dal (Democratic),1238,2,1240,0.12,S0430
16,SAROJ KUMAR SUMAN,Socialist Unity Centre Of India (COMMUNIST),1078,0,1078,0.1,S0430
17,SHAHID ALAM,Jantantra Awaj Party,1040,3,1043,0.1,S0430
18,NOTA,None of the Above,5532,27,5559,0.52,S0430
1,RAJPALSINH MAHENDRASINH JADAV,Bharatiya Janata Party,785830,8749,794579,70.22,S0618
2,GULABSINH SOMSINH CHAUHAN,Indian National Congress,279396,5841,285237,25.21,S0618
3,HASMUKHKUMAR GANPATSINH RATHOD,Independent,10376,23,10399,0.92,S0618
4,JITESHKUMAR GHANSHYAMBHAI SEVAK,Dhanwan Bharat Party,8350,39,8389,0.74,S0618
5,MANOJSINH RANAJITSINH RATHOD,Independent,3984,29,4013,0.35,S0618
6,LAXMANBHAI GALABHAI BARIYA,"Aam Janmat Party,",3108,97,3205,0.28,S0618
7,TASLIM MOHAMMEDRAFIK DURVESH,Independent,3051,14,3065,0.27,S0618
8,PANDOR KAUSHIKKUMAR SHANKARBHAI,Independent,2486,21,2507,0.22,S0618
9,NOTA,None of the Above,19629,474,20103,1.78,S0618
1,DR. HEMANT VISHNU SAVARA,Bharatiya Janata Party,600208,1036,601244,43.69,S1322
2,BHARTI BHARAT KAMDI,Shiv Sena (Uddhav Balasaheb Thackrey),416822,1116,417938,30.37,S1322
3,RAJESH RAGHUNATH PATIL,Bahujan Vikas Aaghadi,254011,506,254517,18.5,S1322
4,BHARAT SAMJI VANGA,Bahujan Samaj Party,15425,40,15465,1.12,S1322
5,MEENA KISHOR BHAD,Independent,14223,12,14235,1.03,S1322
6,VIJAYA RAJKUMAR MHATRE,Vanchit Bahujan  Aaghadi,10882,54,10936,0.79,S1322
7,MOHAN BARAKU GUHE,Bharat Adivasi Party,10737,24,10761,0.78,S1322
8,DINKAR DATTATRAYA WADHAN,Independent,10672,15,10687,0.78,S1322
9,AMAR KISAN KAVALE,Independent,9806,15,9821,0.71,S1322
10,COMRADE RAHUL MEDHA,Marxist Leninist Party of India (Red Flag),7061,24,7085,0.51,S1322
11,NOTA,None of the Above,23312,73,23385,1.7,S1322
1,VISHWESHWAR HEGDE KAGERI,Bharatiya Janata Party,777887,4608,782495,61.97,S1012
2,DR. ANJALI NIMBALKAR,Indian National Congress,443296,1771,445067,35.25,S1012
3,RAJSHEKHAR. SHANKAR. HINDALAGI.,Independent,5384,13,5397,0.43,S1012
4,GANAPATI HEGDE,Socialist Unity Centre Of India (COMMUNIST),4427,45,4472,0.35,S1012
5,NIRANJAN UDAYSINH SIRDESAI,Independent,4116,53,4169,0.33,S1012
6,NAGARAJ. ANANT. SHIRALI.,Independent,2860,22,2882,0.23,S1012
7,CHIDANAND  HANUMANTHAPPA HARIJAN,Independent,1707,14,1721,0.14,S1012
8,PRAJAAKEEYA SUNIL,Uttama Prajaakeeya Party,1523,43,1566,0.12,S1012
9,VINAYAK NAIK,Karnataka Rashtra Samithi,1230,33,1263,0.1,S1012
10,K. P. PATIL,Independent,901,55,956,0.08,S1012
11,KRISHNA BALEGAR,Independent,897,23,920,0.07,S1012
12,ARAVIND GOWDA,Independent,872,32,904,0.07,S1012
13,AVINASH. NARAYAN. PATIL.,Independent,761,12,773,0.06,S1012
14,NOTA,None of the Above,10151,25,10176,0.81,S1012
1,TARIQ ANWAR,Indian National Congress,565025,2067,567092,48.41,S0411
2,DULAL CHANDRA GOSWAMI,Janata Dal  (United),516199,1030,517229,44.15,S0411
3,GOPAL KUMAR MAHTO,Bahujan Samaj Party,14452,46,14498,1.24,S0411
4,GYANESHWAR SOREN,Independent,12307,10,12317,1.05,S0411
5,KHALID MOBARAK,Independent,10828,43,10871,0.93,S0411
6,RAJ KUMAR MANDAL,Rashtriya Jansambhavna Party,8473,14,8487,0.72,S0411
7,VISHNU SINGH,Bharat Jago Janta Party,6303,37,6340,0.54,S0411
8,MARANG HANSADA,Peoples Party of India (Democratic),5875,14,5889,0.5,S0411
9,BINDU KUMARI,Samaj Shakti Party,5866,18,5884,0.5,S0411
10,NOTA,None of the Above,22866,73,22939,1.96,S0411
1,GYANESHWAR PATIL,Bharatiya Janata Party,861188,1491,862679,57.04,S1228
2,NARENDRA PATEL,Indian National Congress,591540,1168,592708,39.19,S1228
3,MUNNALAL S/O DHANNALAL TEJI,Bahujan Samaj Party,11796,22,11818,0.78,S1228
4,ABHINESH SINGH,Rashtriya Jan Awaz Party,9295,4,9299,0.61,S1228
5,LAXMI NARAYAN KATARE,Independent,4902,3,4905,0.32,S1228
6,MANOJ KUMAR VISHWAMBHARNATH AGRAWAL,Independent,4346,1,4347,0.29,S1228
7,MAHESH PAWAR,Peoples Party of India (Democratic),3701,8,3709,0.25,S1228
8,SHIVAM SEN,Independent,3479,2,3481,0.23,S1228
9,RAVINDRA SONVANE,Independent,2679,6,2685,0.18,S1228
10,PRAKASH RATHOR BANJARA,Aam Janta Party (India),2368,2,2370,0.16,S1228
11,NARAYAN SUKHADEV PAL,Bharatiya Yuva Jan Ekta Party,1699,3,1702,0.11,S1228
12,NOTA,None of the Above,12817,22,12839,0.85,S1228
1,BASAVARAJ BOMMAI,Bharatiya Janata Party,702189,3349,705538,50.55,S1010
2,ANANDSWAMY GADDADEVARMATH,Indian National Congress,660191,1834,662025,47.43,S1010
3,SUNANDA KARIYAPPA SHIRHATTI,Independent,4705,2,4707,0.34,S1010
4,KHAJAMOHIDDIN GUDAGERI,Socialist Party (India),3398,3,3401,0.24,S1010
5,GANGADHAR BADIGER,Socialist Unity Centre Of India (COMMUNIST),2264,6,2270,0.16,S1010
6,RUDRAPPA BASAPPA KUMBAR,Independent,1352,4,1356,0.1,S1010
7,BASAVARAJ B HADI,Independent,1065,6,1071,0.08,S1010
8,PRAJAKEEYA SACHINKUMAR KARJEKANNAVAR,Uttama Prajaakeeya Party,1058,14,1072,0.08,S1010
9,DR. G H IMRAPUR,Independent,930,23,953,0.07,S1010
10,JAGADISH YALLAPPA BANKAPURA,Independent,660,14,674,0.05,S1010
11,TANU CHIKKANNA YADAV,Karnataka Rashtra Samithi,628,8,636,0.05,S1010
12,H K NARASIMHAPPA,Samajwadi Janata Party(Karnataka),445,1,446,0.03,S1010
13,VISHWANATH SHEERI,Ekam Sanatan Bharat Dal,401,0,401,0.03,S1010
14,RASHEEDA BEGUM,Indian Movement Party,396,1,397,0.03,S1010
15,NOTA,None of the Above,10831,34,10865,0.78,S1010
1,PRAVEEN KHANDELWAL,Bharatiya Janata Party,514958,1538,516496,53.46,U051
2,JAI PRAKASH AGARWAL,Indian National Congress,426542,629,427171,44.22,U051
3,ABUL KALAM AZAD,Bahujan Samaj Party,5820,9,5829,0.6,U051
4,UMESH RATHOR,Atulya Bharat Party,1614,3,1617,0.17,U051
5,SEEMA RIZVI,Azad Samaj Party,1089,0,1089,0.11,U051
6,SHAIK JALEEL,Navarang Congress Party,947,2,949,0.1,U051
7,MD NAZIR,Aman Samaj Party,945,0,945,0.1,U051
8,SATYA DEV CHAUDHARY,Satya Bahumat Party,842,0,842,0.09,U051
9,RITU KAUSHIK,Socialist Unity Centre Of India (COMMUNIST),642,1,643,0.07,U051
10,SAMEER MIRZA,Rashtriya Republican Party,513,0,513,0.05,U051
11,SOHARSH GULGULIA JAIN,Swaraj Bhartiya Nyay Party,503,0,503,0.05,U051
12,SHYAM BHARTEEY,Gareeb Aadmi Party,462,1,463,0.05,U051
13,GULJAR SINGH,Peoples Party of India (Democratic),424,0,424,0.04,U051
14,YOGENDER SINGH,Bharatiya Liberal Party,389,0,389,0.04,U051
15,VINOD KUMAR GUPTA,Akhil Bhartiya Parivar Party,357,2,359,0.04,U051
16,SHIVAM SAINI,Right to Recall Party,330,0,330,0.03,U051
17,MANOJ KUMAR NIGAM,Akhil Bhartiya Sudhar Party,321,0,321,0.03,U051
18,RAJESH GUPTA,Bharat Lok Sewak Party,261,1,262,0.03,U051
19,RAHUL SHARMA,Rashtriya Mangalam Party,256,1,257,0.03,U051
20,SUNIL KUMAR,Independent,247,0,247,0.03,U051
21,SUBHASH CHANDER,Independent,220,0,220,0.02,U051
22,MOHD HAMID,Bharatheeya Jawan Kisan Party,189,0,189,0.02,U051
23,PYUSH NARULA,Independent,172,0,172,0.02,U051
24,HEENA,Public Political Party,169,0,169,0.02,U051
25,ASHOK KUMAR GUPTA,Independent,139,1,140,0.01,U051
26,NOTA,None of the Above,5544,19,5563,0.58,U051
1,SOUGATA RAY,All India Trinamool Congress,526289,2290,528579,41.95,S2516
2,SILBHADRA DATTA,Bharatiya Janata Party,456138,1781,457919,36.34,S2516
3,SUJAN CHAKRABORTY,Communist Party of India  (Marxist),239418,1366,240784,19.11,S2516
4,SHEKH IMANUR RAHMAN,Independent,6410,1,6411,0.51,S2516
5,SWAMINATH KORI,Bahujan Samaj Party,3749,17,3766,0.3,S2516
6,HIRAK SINHA,Independent,3144,3,3147,0.25,S2516
7,BANAMALI PANDA,Socialist Unity Centre Of India (COMMUNIST),1728,11,1739,0.14,S2516
8,DULU DEY,Independent,1688,6,1694,0.13,S2516
9,MANIKA MUKHERJEE,Bharatiya Nyay-Adhikar Raksha Party,1231,6,1237,0.1,S2516
10,SANTANU MANDAL,Democratic Socialist Party of India,880,5,885,0.07,S2516
11,TRIDIB BHUNIA,Independent,765,7,772,0.06,S2516
12,GOURI BISWAS,Independent,698,3,701,0.06,S2516
13,SUBRATA BHOWMIK,Mera Bharat Mahan Party,602,2,604,0.05,S2516
14,HARI PADA BISWAS,Mulnibasi Party of India,465,9,474,0.04,S2516
15,NOTA,None of the Above,11256,78,11334,0.9,S2516
1,BHARATBHAI MANUBHAI SUTARIYA,Bharatiya Janata Party,577820,3052,580872,66.28,S0614
2,JENNY THUMMAR,Indian National Congress,258231,1573,259804,29.64,S0614
3,CHAUHAN RAVAJIBHAI MULABHAI,Bahujan Samaj Party,7486,57,7543,0.86,S0614
4,SANKHAT VIKRAMBHAI VISABHAI,Global Republican Party,4958,51,5009,0.57,S0614
5,BAVKUBHAI AMARUBHAI VALA,Independent,3733,44,3777,0.43,S0614
6,BHAVESHBHAI JENTIBHAI RANK,Independent,3663,8,3671,0.42,S0614
7,PUNJABHAI BAVBHAI DAFDA,Independent,2598,23,2621,0.3,S0614
8,PRITESH CHAUHAN (LALU),Independent,1759,21,1780,0.2,S0614
9,NOTA,None of the Above,11125,224,11349,1.29,S0614
1,DR.SANJAY JAISWAL,Bharatiya Janata Party,578959,1462,580421,53.43,S042
2,MADAN MOHAN TIWARI,Indian National Congress,441363,2490,443853,40.86,S042
3,SANJAY KUMAR,Viro Ke Vir Indian Party,13139,6,13145,1.21,S042
4,UPENDRA RAM,Bahujan Samaj Party,10913,49,10962,1.01,S042
5,MOHAMMAD SOAIB,Independent,8992,2,8994,0.83,S042
6,RAUSHAN KUMAR SRIVASTAVA,Independent,8496,9,8505,0.78,S042
7,MD. KALAM SAI,Independent,4922,3,4925,0.45,S042
8,NAFISH AHMAD,Independent,4163,0,4163,0.38,S042
9,NOTA,None of the Above,11223,65,11288,1.04,S042
1,RAJ BHUSHAN CHOUDHARY,Bharatiya Janata Party,618569,1180,619749,55.71,S0415
2,AJAY NISHAD,Indian National Congress,383759,1063,384822,34.59,S0415
3,ALOK KUMAR SINH,Independent,17225,0,17225,1.55,S0415
4,AWADHESH PRASAD SINGH,Independent,15617,1,15618,1.4,S0415
5,JITENDRA KUMAR,Independent,8692,8,8700,0.78,S0415
6,NILIMA KUMARI,Independent,7309,1,7310,0.66,S0415
7,VIJAYESH KUMAR,Bahujan Samaj Party,6530,17,6547,0.59,S0415
8,AJAY SAHNI,Independent,5157,1,5158,0.46,S0415
9,SUNITA KUMARI,Bajjikanchal Vikas Party,4791,1,4792,0.43,S0415
10,MOHAMMAD ANZARUL HASAN,All India Majlis-E-Ittehadul Muslimeen,4121,10,4131,0.37,S0415
11,MD HAIDAR,Independent,3897,0,3897,0.35,S0415
12,MUKESH KUMAR,Independent,3225,0,3225,0.29,S0415
13,SUDHIR KUMAR OJHA,Bhartiya Sarthak Party,2890,3,2893,0.26,S0415
14,SABINA KHATOON,Indian National League,2445,8,2453,0.22,S0415
15,SANDIP KUMAR,Jantantra Awaj Party,1968,3,1971,0.18,S0415
16,ARVIND KUMAR CHAUDHARY,Socialist Unity Centre Of India (COMMUNIST),1852,5,1857,0.17,S0415
17,AJITANSH GAUR,The Agrani Party,1840,3,1843,0.17,S0415
18,SANJAY KUMAR,Independent,1811,1,1812,0.16,S0415
19,BASKIT KUMAR SHARMA,Independent,1778,1,1779,0.16,S0415
20,SONELAL PASWAN,Independent,1730,1,1731,0.16,S0415
21,MANORANJAN KUMAR,Independent,1595,3,1598,0.14,S0415
22,NAND KISHORE SHARMA,Apna Kisan Party,1521,1,1522,0.14,S0415
23,ABHAY KUMAR,Samata Party,1170,4,1174,0.11,S0415
24,PRABHAKAR RANJAN,Ekam Sanatan Bharat Dal,1115,1,1116,0.1,S0415
25,RAJU SINGH,Independent,984,0,984,0.09,S0415
26,SAROJ KUMAR CHAUDHARY,Independent,965,0,965,0.09,S0415
27,NOTA,None of the Above,7539,49,7588,0.68,S0415
1,VARUN CHAUDHRY,Indian National Congress,662592,1065,663657,49.28,S071
2,BANTO KATARIA,Bharatiya Janata Party,613786,835,614621,45.64,S071
3,PAWAN RANDHAWA,Bahujan Samaj Party,23535,48,23583,1.75,S071
4,GURPREET SINGH,Indian National Lok Dal,8902,84,8986,0.67,S071
5,KAMAL KUMAR BARARA,Aazad Samaj Party (Kanshi Ram),8741,13,8754,0.65,S071
6,KIRAN PUNIA,Jannayak Janta Party,6055,37,6092,0.45,S071
7,RAKESH KUMAR,Haryana Jansena Party,3110,1,3111,0.23,S071
8,BALJEET SINGH,Bharatheeya Jawan Kisan Party,2459,43,2502,0.19,S071
9,MEHAR SINGH CHALIA,Ekam Sanatan Bharat Dal,2383,14,2397,0.18,S071
10,GULAB SINGH NARWAL,Peoples Party of India (Democratic),1683,7,1690,0.13,S071
11,SURAJ KUMAR,Bahujan Mukti Party,1501,5,1506,0.11,S071
12,MOHAR SINGH STATION MASTER (RETD.),Independent,1257,6,1263,0.09,S071
13,BETA MAM CHAND RATTUWALA,Bharatiya Yuva Jan Ekta Party,1248,3,1251,0.09,S071
14,DR. NITESH CHOPRA (HONEY),Bhartiya Shakti Chetna Party,854,3,857,0.06,S071
15,NOTA,None of the Above,6427,25,6452,0.48,S071
1,MANOJ TIGGA,Bharatiya Janata Party,691533,3781,695314,48.92,S252
2,PRAKASH CHIK BARAIK,All India Trinamool Congress,617486,2381,619867,43.61,S252
3,MILI ORAON,Revolutionary Socialist Party,39424,285,39709,2.79,S252
4,PARIMAL ORAON,Independent,12560,24,12584,0.89,S252
5,ARJUN INDWAR,Independent,11090,32,11122,0.78,S252
6,MUNIB NARJINARY,Bahujan Samaj Party,6600,48,6648,0.47,S252
7,RAHUL MARAK,Kisan Mazdoor Sangharsh Party,5679,16,5695,0.4,S252
8,CHANDAN ORAON,Socialist Unity Centre Of India (COMMUNIST),2751,36,2787,0.2,S252
9,BINAY MURMU,North Bengal People’s Party,2700,58,2758,0.19,S252
10,NRIPENDRA NARAYAN DEBKARJEE,Kamatapur People’s Party (United),2017,38,2055,0.14,S252
11,BABITA BARA,Gana Suraksha Party,1522,30,1552,0.11,S252
12,NOTA,None of the Above,21235,63,21298,1.5,S252
1,DR. M.P ABDUSSAMAD SAMADANI,Indian Union Muslim League,559570,2946,562516,54.81,S117
2,K.S HAMZA,Communist Party of India  (Marxist),324562,2194,326756,31.84,S117
3,ADV. NIVEDIDA,Bharatiya Janata Party,123733,1065,124798,12.16,S117
4,ABDUSSAMED MALAYAMPALLI,Independent,1634,19,1653,0.16,S117
5,VINOD,Bahujan Samaj Party,1449,28,1477,0.14,S117
6,HAMSA S/O MOIDUTTY,Independent,952,26,978,0.1,S117
7,BINDHU W/O DEVARAJAN,Independent,826,21,847,0.08,S117
8,HAMZA KADAVANDI,Independent,707,3,710,0.07,S117
9,NOTA,None of the Above,6499,62,6561,0.64,S117
1,MANJU SHARMA,Bharatiya Janata Party,878643,8207,886850,60.61,S207
2,PRATAP SINGH KHACHARIYAWAS,Indian National Congress,549424,5659,555083,37.93,S207
3,RAJESH TANWAR,Bahujan Samaj Party,3420,41,3461,0.24,S207
4,HARI NARAYAN MEENA,Independent,2193,9,2202,0.15,S207
5,RAJEEV ROLIWAL,Independent,962,8,970,0.07,S207
6,YOGESH SHARMA,Independent,811,5,816,0.06,S207
7,NARENDER SHARMA,Rashtriya Sanatan Party,665,4,669,0.05,S207
8,KULDEEP SINGH,Socialist Unity Centre Of India (COMMUNIST),605,10,615,0.04,S207
9,DR. ASEEM VERMA,Independent,562,10,572,0.04,S207
10,PRADEEP VERMA,Indian Peoples Green Party,445,3,448,0.03,S207
11,ADVOCATE HARI KISHAN TIWARI,Bheem Tribal Congress,384,16,400,0.03,S207
12,SHASHANK SINGH ARYA,Right to Recall Party,372,21,393,0.03,S207
13,TRILOK TIWARI,Rashtriya Samta Vikas Party,344,7,351,0.02,S207
14,NOTA,None of the Above,10280,148,10428,0.71,S207
1,ANANTA NAYAK,Bharatiya Janata Party,571133,2790,573923,45.67,S184
2,DHANURJAYA SIDU,Biju Janata Dal,476206,675,476881,37.95,S184
3,BINOD BIHARI NAIK,Indian National Congress,104944,334,105278,8.38,S184
4,JOHN MIRAN MUNDA,Independent,31729,7,31736,2.53,S184
5,SAHEBA JUANGA,Manas Lokshakti Dal,11040,3,11043,0.88,S184
6,SUSHANT KUMAR NAIK,Independent,9041,3,9044,0.72,S184
7,LAMBODAR NAIK,Independent,6778,0,6778,0.54,S184
8,HARIHAR MUNDA,Socialist Unity Centre Of India (COMMUNIST),6569,5,6574,0.52,S184
9,RAGHUMANI NAIK,Independent,4550,6,4556,0.36,S184
10,RAM PRASAD HEMBRAM,Bahujan Samaj Party,3884,11,3895,0.31,S184
11,PITABASA NAIK,AJSU Party,2141,3,2144,0.17,S184
12,NOTA,None of the Above,24746,17,24763,1.97,S184
1,DINESHBHAI MAKWANA (ADVOCATE),Bharatiya Janata Party,606545,5159,611704,63.28,S068
2,BHARAT YOGENDRA MAKWANA,Indian National Congress,321972,3295,325267,33.65,S068
3,ANILKUMAR VASANTBHAI VAGHELA,Bahujan Samaj Party,9448,152,9600,0.99,S068
4,BHITORA BHAVESHKUMAR CHIMANLAL,Gujarat Loktantra Party,2443,15,2458,0.25,S068
5,SHANKARBHAI KHUSHALBHAI RATHOD,Democratic Bharatiya Samaj Party,2345,44,2389,0.25,S068
6,VEDUBHAI KAUTIKBHAI SIRASAT,Jan Sewa Driver Party,1214,7,1221,0.13,S068
7,NOTA,None of the Above,13604,403,14007,1.45,S068
1,SHAFI PARAMBIL,Indian National Congress,552490,5038,557528,49.65,S113
2,K K SHAILAJA TEACHER,Communist Party of India  (Marxist),437333,5689,443022,39.45,S113
3,PRAPHUL KRISHNAN,Bharatiya Janata Party,110701,1278,111979,9.97,S113
4,SHAFI T P,Independent,3715,49,3764,0.34,S113
5,K K SHYLAJA,Independent,1164,15,1179,0.1,S113
6,KUNHIKANNAN PAYYOLI,Independent,867,2,869,0.08,S113
7,SHYLAJA,Independent,661,19,680,0.06,S113
8,SHAFI,Independent,399,23,422,0.04,S113
9,SYLAJA P,Independent,319,7,326,0.03,S113
10,MURALIDHARAN,Independent,261,8,269,0.02,S113
11,NOTA,None of the Above,2855,54,2909,0.26,S113
1,ANIL YESHWANT DESAI,Shiv Sena (Uddhav Balasaheb Thackrey),393342,1796,395138,49.73,S1330
2,RAHUL RAMESH SHEWALE,Shiv Sena,339828,1926,341754,43.01,S1330
3,ABUL HASAN ALI HASAN KHAN,Vanchit Bahujan  Aaghadi,23675,192,23867,3,S1330
4,VIDHYASAGAR ALIAS SURESH BHIMRAO VIDHYAGAR,Bahujan Samaj Party,6462,70,6532,0.82,S1330
5,AKASH LAXMAN KHARATMAL,Independent,1891,8,1899,0.24,S1330
6,ASHWINI KUMAR PATHAK,Independent,1607,5,1612,0.2,S1330
7,ADV. SANTOSH PUNJIRAM SANJKAR,Independent,1565,13,1578,0.2,S1330
8,KARAM HUSSAIN KITABULLAH KHAN,Peace Party,1533,4,1537,0.19,S1330
9,ADV. MAHENDRA TULSHIRAM BHINGARDIVE,Right to Recall Party,1414,30,1444,0.18,S1330
10,SAEED CHOUDHARY,Social Democratic Party Of India,1186,5,1191,0.15,S1330
11,ISHWAR VILAS TATHAWADE,Rashtriya Mahaswaraj Bhumi Party,968,3,971,0.12,S1330
12,DEEPAK M. CHAUGULE,Bahujan Republican  Socialist Party,968,7,975,0.12,S1330
13,JAHID ALI NASIR AHMED SHAIKH,Aazad Samaj Party (Kanshi Ram),957,2,959,0.12,S1330
14,DR. ARJUN MAHADEO MURUDKAR,Bharatheeya Jawan Kisan Party,913,17,930,0.12,S1330
15,VIVEK YESHWANT PATIL,Independent,713,1,714,0.09,S1330
16,NOTA,None of the Above,13316,107,13423,1.69,S1330
1,JITIN PRASADA,Bharatiya Janata Party,605199,1959,607158,52.3,S2426
2,BHAGWAT SARAN GANGWAR,Samajwadi Party,439735,2488,442223,38.09,S2426
3,ANIS AHMED KHAN (PHOOL BABU),Bahujan Samaj Party,89252,445,89697,7.73,S2426
4,RAJEEV KUMAR SAXENA,Bhartiya Krishak Dal,3800,9,3809,0.33,S2426
5,SUSHIL KUMAR SHUKLA,Independent,2723,4,2727,0.23,S2426
6,MOHMMAD SHAHID HUSAIN,Independent,1842,4,1846,0.16,S2426
7,ASHISH KUMAR,Independent,1842,8,1850,0.16,S2426
8,ADARSH PANDEY,Independent,1714,12,1726,0.15,S2426
9,SANJAY KUMAR BHARTI,Rashtriya Samaj Dal (R),1621,10,1631,0.14,S2426
10,PRAMOD BHAI PATEL ALIAS P.K.,Independent,1525,14,1539,0.13,S2426
11,NOTA,None of the Above,6714,27,6741,0.58,S2426
1,ASHISH DUBEY,Bharatiya Janata Party,788721,1412,790133,68.2,S1213
2,DINESH YADAV,Indian National Congress,302892,567,303459,26.19,S1213
3,RAKESH CHOUDHARY,Bahujan Samaj Party,21389,27,21416,1.85,S1213
4,FOJI VIJAY HALDKAR (EX-ARMY),Independent,7028,15,7043,0.61,S1213
5,MAHAVEER JAIN,Independent,6463,5,6468,0.56,S1213
6,ADVOCATE UDAY KUMAR SAHU,Gondvana Gantantra Party,4832,16,4848,0.42,S1213
7,"ER. PRAVIN GAJBHIYE ""DADA""",Independent,3437,3,3440,0.3,S1213
8,POORNESH KUMAR JAIN,Independent,2822,1,2823,0.24,S1213
9,SWATANATRA SAMAJ SEVI VINAY CHAKRAVARTI,Independent,2488,3,2491,0.22,S1213
10,JAGDISH SINGH LODHI,Bhartiya Shakti Chetna Party,1871,4,1875,0.16,S1213
11,DINESH YADAV,Independent,1480,4,1484,0.13,S1213
12,DR. DHAI AKSHAR,Independent,1399,1,1400,0.12,S1213
13,ASHOK RANA,Rashtra Nirman Party,1226,2,1228,0.11,S1213
14,SANTOSH KUMAR KUSHWAHA,Independent,1202,2,1204,0.1,S1213
15,DASAI RAM KOL,Aadim Samaj Party,1099,1,1100,0.09,S1213
16,COMRADE SACHIN JAIN,Socialist Unity Centre Of India (COMMUNIST),868,8,876,0.08,S1213
17,GULAB SINGH,Independent,821,8,829,0.07,S1213
18,LAL SINGH,Rashtriya Samaj Dal (R),748,4,752,0.06,S1213
19,RAMKUMAR PASI,Bahujan Awam Party,684,6,690,0.06,S1213
20,NOTA,None of the Above,4964,22,4986,0.43,S1213
1,CHHOTELAL,Samajwadi Party,465240,608,465848,46.14,S2480
2,RINKI SINGH,Apna Dal (Soneylal),336344,270,336614,33.34,S2480
3,DHANESHWAR,Bahujan Samaj Party,118669,109,118778,11.77,S2480
4,ASHOK KUMAR KANNAUJIYA,Communist Party of India,23830,22,23852,2.36,S2480
5,SUBHAGI,Janhit Sankalp Party,8191,3,8194,0.81,S2480
6,ARVIND KUMAR BHARTI,Rashtriya Samanta Dal,7583,9,7592,0.75,S2480
7,SUKALU,Independent,6701,11,6712,0.66,S2480
8,SHIVPUJAN,Rashtriya Samaj Paksha,6422,22,6444,0.64,S2480
9,SONU NIGAM,Independent,6142,2,6144,0.61,S2480
10,CHANDRIKA PRASAD,Janta Kranti Party (Rashtravadi),3732,9,3741,0.37,S2480
11,PRABHUDAYAL,Rashtriya Samaj Dal (R),3470,1,3471,0.34,S2480
12,RAM SHIROMANI,Sardar Patel Siddhant Party,3116,7,3123,0.31,S2480
13,NOTA,None of the Above,19019,13,19032,1.89,S2480
1,JAGDAMBIKA PAL,Bharatiya Janata Party,462614,689,463303,45.47,S2460
2,BHISHMA SHANKAR ALIAS KUSHAL TIWARI,Samajwadi Party,418910,1665,420575,41.27,S2460
3,AMAR SINGH CHAUDHARY,Aazad Samaj Party (Kanshi Ram),81182,123,81305,7.98,S2460
4,MD. NADEEM,Bahujan Samaj Party,35654,282,35936,3.53,S2460
5,NAUSHAD AZAM,Peace Party,5134,4,5138,0.5,S2460
6,KIRAN DEVI,Independent,3258,3,3261,0.32,S2460
7,NOTA,None of the Above,9431,16,9447,0.93,S2460
1,NILESH DNYANDEV LANKE,Nationalist Congress Party – Sharadchandra Pawar,622144,2653,624797,47.14,S1337
2,DR. SUJAY RADHAKRISHNA VIKHEPATIL,Bharatiya Janata Party,593568,2300,595868,44.95,S1337
3,ALEKAR GORAKH DASHRATH,Independent,44582,15,44597,3.36,S1337
4,DEELIP KONDIBA KHEDKAR,Vanchit Bahujan  Aaghadi,13689,60,13749,1.04,S1337
5,AMOL VILAS PACHUNDKAR,Independent,5491,2,5493,0.41,S1337
6,BHAGWAT DHONDIBA GAIKWAD,Samata Party,4941,3,4944,0.37,S1337
7,UMASHANKAR SHYAMBABU YADAV,Bahujan Samaj Party,4509,30,4539,0.34,S1337
8,ADV. JAMIR SHAIKH,Independent,3934,1,3935,0.3,S1337
9,AARTI KISHORKUMAR HALDAR,Prabuddha Republican Party,3790,9,3799,0.29,S1337
10,NAVSHAD MUNSILAL SHAIKH,Independent,2226,0,2226,0.17,S1337
11,SURYABHAN (ALIAS SURESH) DATTATRAYA LAMBE,Independent,2092,0,2092,0.16,S1337
12,KALIRAM BAHIRU POPALGHAT,Bhartiya Navjawan Sena (Paksha),1975,6,1981,0.15,S1337
13,GAVADE MACCHINDRA RADHAKISAN,Independent,1940,1,1941,0.15,S1337
14,PRAVIN SUBHASH DALVI,Independent,1896,2,1898,0.14,S1337
15,MADAN KANIFNATH SONVANE,Right to Recall Party,1445,6,1451,0.11,S1337
16,DR. KAILASH NIVRUTTI JADHAV,Maharashtra Vikas Aghadi,1425,10,1435,0.11,S1337
17,KOTHARI RAVINDRA LILACHAND,Rashtriya Janmanch (Secular),1330,3,1333,0.1,S1337
18,ADV. SHIVAJIRAO WAMAN DAMALE (EX. SGT OF IAF),Sainik Samaj Party,1093,11,1104,0.08,S1337
19,GANGADHAR HARIBHAU KOLEKAR,Independent,1059,0,1059,0.08,S1337
20,DATTATRAY APPA WAGHMODE,Rashtriya Jankranti Party,868,5,873,0.07,S1337
21,WABLE BHAUSAHEB BAPURAO,Bharatheeya Jawan Kisan Party,790,11,801,0.06,S1337
22,SHEKATKAR ANIL GANPAT,Independent,702,0,702,0.05,S1337
23,ADV. MAHENDRA DADASAHEB SHINDE,Independent,674,1,675,0.05,S1337
24,BILAL GAFUR SHAIKH,Independent,531,0,531,0.04,S1337
25,RAOSAHEB SHANKAR KALE,Independent,370,2,372,0.03,S1337
26,NOTA,None of the Above,3254,28,3282,0.25,S1337
1,ABHAY KUMAR SINHA,Rashtriya Janata Dal,463845,1722,465567,49.22,S0437
2,SUSHIL KUMAR SINGH,Bharatiya Janata Party,384819,1637,386456,40.86,S0437
3,SUNESH KUMAR,Bahujan Samaj Party,20232,77,20309,2.15,S0437
4,PRATIBHA RANI,Peoples Party of India (Democratic),12265,43,12308,1.3,S0437
5,RAJ BALLABH SINGH,Independent,11150,9,11159,1.18,S0437
6,RAMJIT SINGH,Rashtriya Jansambhavna Party,9237,6,9243,0.98,S0437
7,SURESH PRASAD VERMA,Independent,6704,7,6711,0.71,S0437
8,MOHAMMAD WALIULLAH KHAN,Independent,6591,13,6604,0.7,S0437
9,SHAILESH RAHI,Akhil Hind Forward Bloc (Krantikari),4892,4,4896,0.52,S0437
10,NOTA,None of the Above,22566,61,22627,2.39,S0437
1,SHIVRAJ SINGH CHOUHAN,Bharatiya Janata Party,1111556,4904,1116460,76.7,S1218
2,PRATAPBHANU SHARMA,Indian National Congress,293537,1515,295052,20.27,S1218
3,KISHAN LAL LADIYA,Bahujan Samaj Party,10734,82,10816,0.74,S1218
4,KAMLESH KUMAR GOUR,Jai Prakash Janata Dal,8167,11,8178,0.56,S1218
5,DHOOLSINGH DHAMMA,Independent,3417,7,3424,0.24,S1218
6,SATYENDRA SINGH SISODIYA,Independent,2921,4,2925,0.2,S1218
7,DHARMVIR BHARTI,Akhil Bhartiya Parivar Party,2809,10,2819,0.19,S1218
8,ABDUL RASHID,Independent,1679,3,1682,0.12,S1218
9,BHAI MUNSHILAL SILAWAT,Public Political Party,1114,3,1117,0.08,S1218
10,ABDUL JABBAR,Independent,1076,6,1082,0.07,S1218
11,SEEMA SHARMA,Sapaks Party,1065,8,1073,0.07,S1218
12,DHARMENDRA SINGH PANWAR (GOLU BHAIYA),Right to Recall Party,1025,1,1026,0.07,S1218
13,BHEEKAM SINGH KUSHWAHA,Mahanwadi Party,720,4,724,0.05,S1218
14,NOTA,None of the Above,9218,62,9280,0.64,S1218
1,JOBA MAJHI,Jharkhand Mukti Morcha,515989,4175,520164,51.62,S2710
2,GEETA KORA,Bharatiya Janata Party,349006,2756,351762,34.91,S2710
3,DAMODAR SINGH HANSDA,Independent,43838,454,44292,4.4,S2710
4,MADHAV CHANDRA KUNKAL,Independent,19729,105,19834,1.97,S2710
5,SANGRAM MARDI,Independent,16097,14,16111,1.6,S2710
6,PARDESHI LAL MUNDA,Bahujan Samaj Party,8708,34,8742,0.87,S2710
7,DURGA LAL MURMU,Independent,4912,12,4924,0.49,S2710
8,CHITRASEN SINKU,Jharkhand Party,3188,22,3210,0.32,S2710
9,BISHWA VIJAY MARDI,Ambedkarite Party of India,3067,3,3070,0.3,S2710
10,ASHA KUMARI RUNDA,Independent,2736,18,2754,0.27,S2710
11,KRISHNA MARDI,Jharkhand Mukti Morcha  (Ulgulan),2597,18,2615,0.26,S2710
12,SUDHA RANI BESRA,Peoples Party of India (Democratic),2398,11,2409,0.24,S2710
13,BIR SINGH DEOGAM,Right to Recall Party,1919,8,1927,0.19,S2710
14,PANMANI SINGH,Socialist Unity Centre Of India (COMMUNIST),1793,8,1801,0.18,S2710
15,NOTA,None of the Above,23907,75,23982,2.38,S2710
1,KHADSE RAKSHA NIKHIL,Bharatiya Janata Party,629558,1321,630879,53.84,S134
2,SHRIRAM DAYARAM PATIL,Nationalist Congress Party – Sharadchandra Pawar,358030,666,358696,30.61,S134
3,ER. SANJAY PANDIT BRAMHANE,Vanchit Bahujan  Aaghadi,59001,119,59120,5.05,S134
4,EKNATH NAGO SALUNKE,Independent,43957,25,43982,3.75,S134
5,GULAB DAYARAM BHIL,Bharat Adivasi Party,9622,22,9644,0.82,S134
6,MAMTA ALIAS MUMTAJ BHIKARI TADVI,Independent,7874,10,7884,0.67,S134
7,VIJAY RAMKRUSHNA KALE,Bahujan Samaj Party,7551,26,7577,0.65,S134
8,VASANT SHANKAR KOLTE,Independent,6713,5,6718,0.57,S134
9,PRAVIN LAXMAN PATIL,Independent,6087,5,6092,0.52,S134
10,YUVRAJ DEVSING BARELA,Independent,5131,4,5135,0.44,S134
11,ASHOK BABURAO JADHAV,Peoples Party of India (Democratic),4686,4,4690,0.4,S134
12,SHRIRAM SITARAM PATIL,Independent,4264,5,4269,0.36,S134
13,JITENDRA PANDURANG PATIL,Independent,3582,5,3587,0.31,S134
14,SANJAY PRALHAD KANDELKAR,Independent,2954,7,2961,0.25,S134
15,SAGAR PRABHAKAR PATIL,Independent,2932,3,2935,0.25,S134
16,SANJAYKUMAR LAXMAN WANKHEDE,Republican Party of India (Social),2277,5,2282,0.19,S134
17,ANIL PITAMBAR WAGH (SIR),Independent,2265,13,2278,0.19,S134
18,PROF. DR. ASHISH SUBHASH JADHAV,Independent,1919,8,1927,0.16,S134
19,BHIVRAJ RAMDAS RAYSINGE,Independent,1807,2,1809,0.15,S134
20,KOMALBAI BAPURAO PATIL,Independent,1424,5,1429,0.12,S134
21,SHAIKH AABID SHAIKH BASHIR,Independent,1035,5,1040,0.09,S134
22,AMIT HARIBHAU KOLTE,Independent,980,1,981,0.08,S134
23,DR. YOGENDRA VITTHAL KOLTE,Independent,900,2,902,0.08,S134
24,SHRIRAM OMKAR PATIL,Independent,743,6,749,0.06,S134
25,NOTA,None of the Above,4073,27,4100,0.35,S134
1,ARJUN RAM MEGHWAL,Bharatiya Janata Party,561240,5497,566737,50.68,S202
2,GOVINDRAM MEGHWAL,Indian National Congress,506966,4060,511026,45.7,S202
3,KHETA RAM,Bahujan Samaj Party,8249,50,8299,0.74,S202
4,ATMA RAM GUJARATI,Independent,6267,14,6281,0.56,S202
5,RATANI DEVI,Independent,3894,32,3926,0.35,S202
6,SATYANARAYAN DEVRA,Independent,2958,8,2966,0.27,S202
7,PUKHRAJ NAYAK,Independent,2621,54,2675,0.24,S202
8,BABU LAL,Independent,2010,9,2019,0.18,S202
9,GOPI CHAND MEGHWAL,Independent,1787,8,1795,0.16,S202
10,NOTA,None of the Above,12431,127,12558,1.12,S202
1,SHRIPAD YESSO NAIK,Bharatiya Janata Party,253812,3514,257326,56.43,S051
2,RAMAKANT KHALAP,Indian National Congress,140191,1120,141311,30.99,S051
3,TUKARAM BHARAT PARAB,Revolutionary Goans Party,45460,233,45693,10.02,S051
4,MILAN R VAINGANKAR,Bahujan Samaj Party,1600,25,1625,0.36,S051
5,MR SAKHARAM NAIK,Akhil Bhartiya Parivar Party,1404,13,1417,0.31,S051
6,SHAKEEL JAMAL SHAIKH,Independent,800,7,807,0.18,S051
7,THOMAS AUGUSTINE FERNANDES,Independent,746,13,759,0.17,S051
8,ADV VISHAL NAIK,Independent,744,8,752,0.16,S051
9,NOTA,None of the Above,6297,31,6328,1.39,S051
1,RAJESH RANJAN ALIAS PAPPU YADAV,Independent,566867,689,567556,47.46,S0412
2,SANTOSH KUMAR,Janata Dal  (United),543313,396,543709,45.47,S0412
3,BIMA BHARTI,Rashtriya Janata Dal,27017,103,27120,2.27,S0412
4,ARUN DAS,Bahujan Samaj Party,10595,24,10619,0.89,S0412
5,SATYENDRA YADAV,Independent,8457,2,8459,0.71,S0412
6,NOMAN ALAM,Independent,7693,0,7693,0.64,S0412
7,KISHOR KUMAR YADAV,All India Forward Bloc,6846,8,6854,0.57,S0412
8,NOTA,None of the Above,23819,15,23834,1.99,S0412
1,ANAND KUMAR,Bharatiya Janata Party,518575,227,518802,49.1,S2456
2,RAMESH CHANDRA,Samajwadi Party,454454,121,454575,43.02,S2456
3,DR. BRIJESH KUMAR,Bahujan Samaj Party,50422,26,50448,4.77,S2456
4,ARVIND KUMAR,Bhartiya Awam Party (Rastriya),6158,2,6160,0.58,S2456
5,RAMESH BALMIKI,Independent,3223,4,3227,0.31,S2456
6,BECHULAL,Independent,2919,1,2920,0.28,S2456
7,JANARDAN GOND,Independent,2672,1,2673,0.25,S2456
8,RAM MILAN,Sardar Patel Siddhant Party,1699,0,1699,0.16,S2456
9,RINKU SAHANI,Rashtra Dharak Dal,1681,2,1683,0.16,S2456
10,JAGRAM,Independent,1514,1,1515,0.14,S2456
11,NOTA,None of the Above,12862,2,12864,1.22,S2456
